우리 아는 볼움물이 들어가는 것까정 지 아부지르 닮었잖소.	우리/NP 아__23/NNG 는/JX 볼움물__1/NNG 이/JKS 들어가/VV 는/ETM 것/NNB 까정/JX 지__51/NP 아부지__2/NNG 르/JKO 닮/VV 었/EP 지/EC 않/VX 소/EF ./SF	우리 아이는 볼우물이 들어가는 것까지 제 아버지를 닮았잖소.
겨욹에는 낭그를 짚으로 싸뎅에야 한다.	겨욹__1/NNG 에/JKB 는/JX 낭그__1/NNG 를/JKO 짚/NNG 으로/JKB 싸뎅이/VV 어야/EC 하/VX ᆫ다/EF ./SF	겨울에는 나무를 짚으로 싸매야 한다.
요짐에는 어딜 가두 지풀집으 찾어볼 수 웂아.	요짐__1/NNG 에/JKB 는/JX 어디/NP ᆯ/JKO 가/VV 어두/EC 지풀집__1/NNG 으/JKO 찾/VV 어/EC 보/VV ᆯ/ETM 수/NNB 웂__1/VA 아/EF ./SF	요즘에는 어딜 가도 초가집을 찾아볼 수 없어.
지냑을 너머 일찌거니 먹었드니 입이 꿉꿉하다.	지냑__1/NNG 을/JKO 너머__2/MAG 일찌거니/MAG 먹/VV 었/EP 드니/EC 입/NNG 이/JKS 꿉꿉하__3/VA 다/EF ./SF	저녁을 너무 일찌거니 먹었더니 입이 궁금하다.
어젯밤부터 즘심때까정 장곧 잤나?	어젯밤/NNG 부터/JX 즘심때__1/NNG 까정/JX 장곧__1/MAG 자/VV 었/EP 나/EF ?/SF	어젯밤부터 점심때까지 줄곧 잤니?
쪼구매한 기 빠르긴 음청 빠르네.	쪼구매/NNG 하/XSA ᆫ/ETM 기__76/NNB 이/JKS 빠르/VA 기/ETN ᆫ/JX 음청__3/MAG 빠르/VA 네/EF ./SF	쪼그마한 게 빠르긴 엄청 빠르네.
즈녁 먹기엔 적빠른 시간이야.	즈녁__1/NNG 먹/VV 기/ETN 에/JKB ᆫ/JX 적빠르/VA ᆫ/ETM 시간/NNG 이/VCP 야/EF ./SF	저녁 먹기엔 어지빠른 시간이야.
장에 갔으문 하더모해 과일이래두 좀 사오지 그랬나?	장/NNG 에/JKB 가/VV 었/EP 으문/EC 하더모해__1/MAG 과일/NNG 이/VCP 래두/EC 좀/MAG 사/VV 어/EC 오/VV 지/EC 그렇/VA-I 었/EP 나/EF ?/SF	장에 갔으면 하다못해 과일이라도 좀 사오지 그랬니?
빈집에서 갑재기 사램이 퇴나와서 얼매나 씩겁단장했는지 몰러요.	빈집/NNG 에서/JKB 갑재기__1/MAG 사램__1/NNG 이/JKS 퇴나오/VV 어서/EC 얼매나__1/MAG 씩겁단장/XR 하/XSV 었/EP 는지/EC 모르/VV 어요/EF ./SF	빈집에서 갑자기 사람이 튀어나와서 얼마나 식겁했는지 몰라요.
오늘 즘심은 이 떡으루 어지자.	오늘/NNG 즘심__1/NNG 은/JX 이/MM 떡/NNG 으루/JKB 어지__2/VV 자/EF ./SF	오늘 점심은 이 떡으로 때우자.
아 때는 싸드바리로 배깥을 돌아댕기기도 하다와.	아__23/NNG 때/NNG 는/JX 싸드바리__1/NNG 로/XSM 배깥__1/NNG 을/JKO 돌아댕기__1/VV 기/ETN 도/JX 하/VX 다와/EF ./SF	아이 때는 알몸으로 바깥을 돌아다니기도 합디다
이따가 지냑에 동네 으른들 모세 놓구 술대즙으 한다든데요.	이따가/MAG 지냑__1/NNG 에/JKB 동네/NNG 으른__1/NNG 들/XSN 모시/VV 어/EC 놓/VV 구/EC 술대즙__1/NNG 으/JKO 하/VV ᆫ다든데/EF 요/JX ./SF	이따가 저녁에 동네 어른들 모셔 놓고 술대접을 한다던데요.
할루근네 한 번씩 말으 일기든 우리 아덜내미거 이제는 다 커서 취직으 했잖소.	할루근네__1/MAG 한/MM 번/NNB 씩/XSN 말__34/NNG 으/JKO 일기__1/VV 든/ETM 우리/NP 아덜내미__1/NNG 거/JKS 이제/NNG 는/JX 다/MAG 크/VV 어서/EC 취직/NNG 으/JKO 하/XSV 었/EP 지/EC 않/VX 소/EC ./SF	하루건너 한 번씩 말썽을 일으키던 우리 아들내미가 이제는 다 커서 취직을 했잖소.
되바래진 어린눔이 버르장머리라군 웂구 아주 앨미르와.	되바라래지/VV ᆫ/ETM 어린눔__1/NNG 이/JKS 버르장머리/NNG 이/VCP 라구/EC ᆫ/JX 웂__1/VA 구/EC 아주/MAG 앨미릅/VA-I 어/EF ./SF	되바라진 어린놈이 버르장머리라곤 없고 아주 얄미워.
지가 잘못해 놓구 외루 화르 내드라니!	지__49/NNG 가/JKS 잘못/MAG 하/VV 어/EC 놓/VX 구/EC 외루__3/MAG 화/NNG 르/JKO 내/VV 드라니/EF !/SF	자기가 잘못해 놓고 외려 화를 내더라니!
맛없는 음석이래도 개 주자니 아꿉다.	맛없/VA 는/ETM 음석__1/NNG 이/VCP 래도/EC 개/NNG 주/VV 자니/EC 아꿉__1/VA-I 다/EF ./SF	맛없는 음식이라도 개 주자니 아깝다.
말 안 듣구 나가 놀다가 넘어졌다니 그것 아주 싸고지다.	말/NNG 안/MAG 듣/VV-I 구/EC 나가/VV 어/EC 놀/VV 다가/EC 넘어지/VV 었/EP 다니/EC 그것/NP 아주/MAG 싸고지__1/NNG 이/VCP 다/EF ./SF	말 안 듣고 나가 놀다가 넘어졌다니 그것 아주 쌤통이다.
자는 어렜을 적부터 대두 쫄라 대는 버릇이 있었아.	자/NP 는/JX 어리/VA 었/EP 을/ETM 적/NNB 부터/JX 대두__9/MAG 쪼르/VV 어/EC 대/VX 는/ETM 버릇/NNG 이/JKS 있/VV 었/EP 아/EF ./SF	쟤는 어렸을 적부터 되우 졸라 대는 버릇이 있었어.
초저욹이래두 바람이 차니까 옷으 뜨시게 입구 나가라.	초저욹__1/NNG 이/VCP 래두/EC 바람/NNG 이/JKS 차/VA 니까/EC 옷/NNG 으/JKO 뜨시__1/VA 게/EC 입/VV-R 구/EC 나가/VV 라/EF ./SF	초겨울이라도 바람이 차니까 옷을 따뜻하게 입고 나가라.
책상 모새이에 부닺헤서 멍당구가 시퍼렇게 들었아.	책상/NNG 모새이__1/NNG 에/JKB 부닺히/VV 어서/EC 멍당구__1/NNG 가/NNG 시퍼렇/VA-I 게/EC 들/VV 었/EP 아/EF ./SF	책상 모서리에 부딪혀서 멍이 시퍼렇게 들었어.
올해는 가믐더우 땜에 나락이 쨀고 그래서 걱정이래. 	올해/NNG 는/JX 가믐더우__1/NNG 땜/NNB 에/JKB 나락__2/NNG 이/MM 쨀__1/VA 고/EC 그래서/MAJ 걱정/NNG 이/VCP 래/EF ./SF	올해는 가뭄더위 땜에 벼가 잘고 그래서 걱정이래.
버점은 허옇기 일어나는 것도 있고 자꾸 번지 나가는 것도 있어여.	버점__1/NNG 은/JX 허옇/VA-I 기/ETN 일어나/VV 는/ETM 것/NNB 도/JX 있/VA 고/EC 자꾸/MAG 번지/VV 어/EC 나가/VX 는/ETM 것/NNB 도/JX 있/VA 어여/EF ./SF	버짐은 허옇게 일어나는 것도 있고 자꾸 번져 나가는 것도 있어요.
우산 없이 길으 가다가 소나기르 좔락 다 맞았다.	우산/NNG 없이/MAG 길/NNG 으/JKO 가/VV 다가/EC 소나기/NNG 르/JKO 좔락__1/MAG 다/MAG 맞/VV 었/EP 다/EF ./SF	우산 없이 길을 가다가 소나기를 쫄딱 다 맞았다.
콩국시가 아주 걸찌한 기 맛이 참 고만이네.	콩국시__1/NNG 가/JKS 아주/MAG 걸찌/XR 하/XSA ᆫ/ETM 기__76/NNB 이/JKS 맛/NNG 이/JKS 참/MAG 고만/MAG 이/VCP 네/EF ./SF	콩국수가 아주 걸쭉한 게 맛이 참 고만이네.
가서 쇠궁이에 여물 좀 줘라. 	가/VV 어서/EC 쇠궁이__1/NNG 에/JKB 여물/NNG 좀/MAG 주/VV 어라/EF ./SF	가서 소구유에 여물 좀 줘라.
구리가 궁게이로 드가 뿠어.	구렁이/NNG 가/JKS 궁게이__1/NNG 로/XSM 드가/VV 어/EC 뿌/VX 었/EP 어/EF ./SF	구렁이가 구멍으로 들어가 버렸어.
엉차 내가 다 할 일이잖소.	엉차__1/MAG 나/NP 가/JKS 다/MAG 하/VV ᆯ/ETM 일/NNG 이/VCP 잖소/EF ./SF	어차피 내가 다 할 일이잖소.
어제 자에 갔더거 어릴 적 친구르 맞주이했잖소.	어제/MAG 자__53/NNG 에/JKB 가/VV 었/EP 더거/EC 어리/VA ᆯ/ETM 적/NNB 친구/NNG 르/JKO 맞주이하/VV 었/EP 잖소/EF ./SF	어제 장에 갔다가 어릴 적 친구와 마주쳤잖소.
떡으 할라모 실그가 있어야 하잖소.	떡/NNG 으/JKO 하/VV ᆯ라모/EC 실그__1/NNG 가/JKS 있/VV 어야/EC 하/VX 잖소/EF ./SF	떡을 하려면 시루가 있어야 하잖소.
자는 처래미 놔두모 종일 잘 놈이야.	자/NP 는/JX 처래미__1/MAG 놔두/VV 모/EC 종일/NNG 자/VV ᆯ/ETM 놈/NNB 이/VCP 야/EF ./SF	쟤는 그대로 놔두면 종일 잘 놈이야.
니는 왜 지냑도 안 먹고 씨뚜룩한 얼굴으 하고 있나?	니/NP 는/JX 왜/MAG 지냑__1/NNG 도/JX 안/MAG 먹/VV 고/EC 씨뚜룩/XR 하/XSA ᆫ/ETM 얼굴/NNG 으/JKO 하/VV 고/EC 있/VX 나/EF ?/SF	너는 왜 저녁도 안 먹고 씨무룩한 얼굴을 하고 있니?
니는 옆차개에드거 머이를 그러 불룩하게 늫고 다니나?	니/NP 는/JX 옆차개__2/NNG 에드거/JKB 머이__5/NP 를/JKO 그러/MAG 불룩/MAG 하/XSA 게/EC 늫__1/VV 고/EC 다니/VV 나/EF ?/SF	너는 호주머니에다가 무엇을 그렇게 불룩하게 넣고 다니니?
머리가 너머 짧어서 잘 묶이키지 않어요.	머리/NNG 가/JKS 너머__2/MAG 짧/VA 어서/EC 잘/MAG 묶이키__1/VV 지/EC 않/VX 어요/EF ./SF	머리가 너무 짧아서 잘 묶이지 않아요.
다 잡은 퇴끼를 털괐아.	다/MAG 잡/VV-R 은/ETM 퇴끼__2/NNG 를/JKO 털구/VV 었/EP 어/EF ./SF	다 잡은 토끼를 놓쳤어.
집이 너무 오래 돼사 허시릅구나.	집/NNG 이/JKS 너무/MAG 오래/MAG 되/VV 어사/EC 허시릅__1/VA 구나/EF ./SF	집이 너무 오래 되어서 허름하구나.
마눌루 담근 장쩨이 좋아하나?	마눌__1/NNG 루/JKB 담그/VV ᆫ/ETM 장쩨이__1/NNG 좋아하/VV 나/EF ?/SF	마늘로 담근 장아찌 좋아하니?
어머야라 니 언제 왔나?	어머야라__1/IC 니/NP 언제/MAG 오/VV 었/EP 나/EF ?/SF	어머 너 언제 왔니?
감재를 캐문 상찌리로만 골러서 자석들한테 보내지요.	감재__1/NNG 를/JKO 캐/VV 어/EC 물/VV ᆫ/ETM 상찌리__1/NNG 로/JKB 만/JX 고르/VV 어서/EC 서/JKB 자석__1/NNG 들/XSN 한테/JKB 보내/VV 지요/EF ./SF	감자를 캐면 상길로만 골라서 자식들한테 보내지요.
어젯밤 바람에 밤꼬쇠이가 마이 떨어졌든데요.	어젯밤/NNG 바람/NNG 에/JKB 밤꼬쇠이__1/NNG 가/JKS 마이__1/MAG 떨어지/VV 었/EP 든데요/EF ./SF	어젯밤 바람에 밤송이가 많이 떨어졌던데요.
즈녁나절쯤이문 밭일두 얼치 끝나요.	즈녁나절__1/NNG 쯤/XSN 이/VCP 문/EC 밭일/NNG 두/JX 얼치__1/MAG 끝나/VV 어요/EF ./SF	저녁나절쯤이면 밭일도 얼추 끝나요.
감재 캐러 갔더거 그 오래비를 딱 맞중이했잔.	감재__1/NNG 캐/VV 러/EC 가/VV 었/EP 더거/EC 그/MM 오래비/NNG 를/JKO 딱/MAG 맞중이하/VV 었/EP 잔/EF ./SF	감자 캐러 갔다가 그 오빠를 딱 마주쳤잖아.
형제들찌리 째그럭거리는 일은 웂어야지.	형제/NNG 들/XSN 찌리/XSN 째그럭거리__1/VV 는/ETM 일/NNG 은/JX 웂__1/VA 어야지/EF ./SF	형제들끼리 짜그락거리는 일은 없어야지.
우리 첫째 아나랑 둘째 사우랑 어릴 때 친구였아.	우리/NP 첫째/NR 아나__7/NNG 랑/JC 둘째/NR 사우__1/NNG 랑/JC 어리/VA ᆯ/ETM 때/NNG 친구/NNG 이/VCP 었/EP 아/EF ./SF	우리 첫째 며느리랑 둘째 사위랑 어릴 때 친구였어.
으제이뜨제이 다 모아 놓구 뭔 일으 꾸미고 있나?	으제이뜨제이__1/MAG 다/MAG 모으/VV 어/EC 놓/VX 구/EC 뭔/MM 일/NNG 으/JKO 꾸미/VV 고/EC 있/VX 나/EF ?/SF	어중이떠중이 다 모아 놓고 뭔 일을 꾸미고 있니?
누거 이 냄비르 이러 짜불띠렜나?	누거/NNG 이/MM 냄비/NNG 르/JKO 이러/MAG 짜불띠리/VV 었/EP 나/EF ?/SF	누가 이 냄비를 이렇게 짜부라뜨렸니?
읎는 헹펜에 반듯한 농토 매련하기가 죄련찮지요.	읎__1/VA 는/ETM 헹펜__2/NNG 에/JKB 반듯/XR 하/XSA ᆫ/ETM 농토/NNG 매련하__2/VV 기/ETN 가/JKS 죄련찮__1/VA 지요/EF ./SF	없는 형편에 반듯한 농토 마련하기가 조련찮지요.
결혼을 할라면 우선 살 집이라도 우그린 후에 해야지.	결혼/NNG 을/JKO 하/VV ᆯ라면/EC 우선/MAG 살/VV ᆯ/ETM 집/NNG 이/VCP 라도/EC 우그리__3/VV ᆫ/ETM 후/NNG 에/JKB 하/VV 어야지/EF ./SF	결혼을 하려면 우선 살 집이라도 마련한 후에 해야지.
도랑물으 타주콰서 논에 물을 좌라.	도랑/NNG 물/NNG 으/JKO 타주쿠/VV 어서/EC 논/NNG 에/JKB 물/NNG 을/JKO 조__2/VV 어라/EF ./SF	도랑물을 터뜨려서 논에 물을 줘라.
싸전 아지매는 됫박질으 할 때 말방치로 그양 미는 기 아니라 파면서 미니 징말루 얄똥시루와. 	싸전/NNG 아지매__1/NNG 는/JX 됫박/NNG 질/XSN 으/JKO 하/VV ᆯ/ETM 때/NNG 말방치__1/NNG 로/JKB 그양__1/MAG 밀/VV 는/ETM 기__76/NNB 이/JKS 아니/VCN 라/EC 파/VV 면서/EC 밀/VV 니/EC 징말루__1/MAG 얄똥시룹/VV 어/EF ./SF	싸전 아주머니는 됫박질을 할 때 평미레로 그냥 미는 게 아니라 파면서 미니 정말로 얄미워.
쪼매한 걸 거기다 꽂아 놓고 맹길었어, 이러.	쪼매/XR 하/XSV ᆫ/ETM 거/NNB ᆯ/JKO 거기/NP 다/JX 꽂/VV 어/EC 놓/VX 고/EC 맹길__1/VV 었/EP 어/EC ,/SP 이러/MAG ./SF	조그마한 걸 거기다 꽂아 놓고 만들었어, 이렇게.
줄으 단디이 짠매라.	줄/NNG 으/JKO 단디이__1/MAG 짠매__1/VV 어라/EF ./SF	줄을 단단히 잡아매라.
밭짐으 서너 번은 매야 곡석이 잘돼.	밭짐__1/NNG 으/JKO 서너/MM 번/NNB 은/JX 매/VV 어야/EC 곡석__1/NNG 이/JKS 잘/MAG 되/VV 어/EF ./SF	밭풀을 서너 번은 매야 곡식이 잘돼.
누거 장작데미르 허물고띠렜나?	누거/NNG 장작데미__1/NNG 르/JKO 허물고띠리/VV 었/EP 나/EF ?/SF	누가 장작더미를 허물어뜨렸니?
옛날 서당에서는 잘못한 일이 있으문 싸리낭그루 종아리르 맞았다드라.	옛날/NNG 서당/NNG 에서/JKB 는/JX 잘못/MAG 하/XSV ᆫ/ETM 일/NNG 이/JKS 있/VV 으문/EC 싸리낭그__1/NNG 루/JKB 종아리/NNG 르/JKO 맞/VV 었/EP 다드라/EF ./SF	옛날 서당에서는 잘못한 일이 있으면 싸리나무로 종아리를 맞았다더라.
빨랫감으 이러 치무제 놓구 어데르 가나?	빨랫감/NNG 으/JKO 이러/MAG 치무지/VV 어/EC 놓/VV 구/EC 어데__2/NP 르/JKO 가/VV 나/EF ?/SF	빨랫감을 이렇게 치쌓아 놓고 어디를 가니?
배가 고프다드니 밥은 시큰 먹었나?	배/NNG 가/JKS 고프/VA 다/EC 들/VX 니/EC 밥/NNG 은/JX 시큰__2/MAG 먹/VV 었/EP 나/EF ?/SF	배가 고프다더니 밥은 실컷 먹었니?
싱검이 든 기 없어지려면 족히 한 달은 걸리겠다.	싱검__1/NNG 이/JKS 들/VV ᆫ/ETM 기__76/NNB 이/JKS 없/VA 어/EC 지/VX 려면/EC 족히/MAG 한/MM 달/NNB 은/JX 걸리/VV 겠/EP 다/EF ./SF	멍이 든 게 없어지려면 족히 한 달은 걸리겠다.
예즌에 우리 둘이 약속한 거 생각나나?	예즌__1/NNG 에/JKB 우리/NP 둘/NR 이/JKS 약속/NNG 하/XSV ᆫ/ETM 거/NNB 생각/NNG 나/VV 나/EF ?/SF	예전에 우리 둘이 약속한 거 생각나니?
그 옷이 삐까리가 참 좋다야.	그/MM 옷/NNG 이/JKS 삐까리__2/NNG 가/JKS 참/MAG 좋/VA 다야/EF ./SF	그 옷이 빛깔이 참 좋다야.
왜서 해피랄 이러 바쁠 때 놀러 가나?	왜서/MAG 해피랄__1/MAG 이러/MAG 바쁘/VA ᆯ/ETM 때/NNG 놀/VV 러/EC 가/VV 나/EF ?/SF	왜 해필 이렇게 바쁠 때 놀러 가니?
가는 하는 짓이 벨시루운 기 아주 밉괄시루와.	가/NP 는/JX 하/VV 는/ETM 짓/NNG 이/JKS 벨시롭/VA-I 은/ETM 기__76/NNB 이/JKS 아주/MAG 밉괄시룹/VA-I 어/EF ./SF	걔는 하는 짓이 별스러운 게 아주 밉살스러워.
아문 모재나 씨구 가라.	아문__10/MM 모재__8/NNG 나/JC 씨__3/VV 구/EC 가/VV 라/EF ./SF	아무 모자나 쓰고 가라.
옥시끼 껍지는 거름테미에 갖다 버레라.	옥시끼__1/NNG 껍지__1/NNG 는/JX 거름테미__1/NNG 에/JKB 갖/VV 다/EC 버리/VV 어라/EF ./SF	옥수수 껍질은 두엄자리에 갖다 버려라.
왜서 이러 등디기가 자주 개룹나?	왜서/MAG 이러/MAG 등디기__1/NNG 가/NNG 자주/MAG 개룹__1/VA-I 나/EF ?/SF	왜 이렇게 등이 자주 가렵니?
저기 샘물둔지에 가서 목이나 췩이구 가자.	저기/NP 샘물둔지__1/NNG 에/JKB 가/VV 어서/EC 목/NNG 이나/JC 췩이__1/VV 구/EC 가/VV 자/EF ./SF	저기 샘물터에 가서 목이나 축이고 가자.
옆집 두 내우분은 어데 댕겨오시는가 보드라.	옆집/NNG 두/MM 내우분__1/NNG 은/JX 어데__2/NP 댕겨오__1/VV 시/EP 는가/EC 보/VX 드라/EF ./SF	옆집 두 내외분은 어디 다녀오시는가 보더라.
부애가 난 날에느 대림질으 하지 마고 마실이나 댕게오시우.	부애__4/NNG 가/JKS 나/VV ᆫ/ETM 날/NNG 에/JKB 느/JX 대림질__1/NNG 으/JKO 하/VV 지/EC 마/VX 고/EC 마실__2/NNG 이나/JC 댕기/VV 어/EC 오/VV 시우/EF ./SF	부아가 난 날에는 다리미질을 하지 말고 마을이나 다녀오세요.
뽁닥양지에사 일을 하니 죽겠다라.	뽁닥양지__1/NNG 에사/JKB 일/NNG 을/JKO 하/VV 니/EC 죽/VV 겠/EP 다라/EF ./SF	땡볕에서 일을 하니 죽겠더라.
오랜만에 술을 먹었더니 삐리하다라.	오랜만/NNG 에/JKB 술/NNG 을/JKO 먹/VV 었/EP 더니/EC 삐리하__1/VA 다라/EF ./SF	오랜만에 술을 먹었더니 얼근하더라.
신비하구 신랭이 좀 닮었든데요.	신비__4/NNG 하구/JC 신랭__1/NNG 이/JKS 좀/MAG 닮/VV 었/EP 든데요/EF ./SF	신부하고 신랑이 좀 닮았던데요.
옛날에 애들이 장난치다가 장독사래 뿌숴도 야단이나 치고 말었지, 뭐.	옛날/NNG 에/JKB 애/NNG 들/XSN 이/JKS 장난치/VV 다가/EC 장독사래__1/NNG 뿌수/VV 어도/EC 도/JX 야단/NNG 이나/JX 치/VV 고/EC 말/VX 었/EP 지/EC ,/SP 뭐/IC ./SF	옛날에 애들이 장난치다가 장독소래기 부숴도 야단이나 치고 말았지, 뭐.
가겟바에 가서 아버지 좀 모세 와라.	가겟바__1/NNG 에/JKB 가/VV 어서/EC 아버지/NNG 좀/MAG 모시/VV 어/EC 오/VX 어라/EF ./SF	가겟방에 가서 아버지 좀 모셔 와라.
낭그쪼가리 좀 더 넣어 가주구 불을 잉글잉글하게 해 봐라.	낭그쪼가리__1/NNG 좀/MAG 더/MAG 넣/VV 어/EC 가주/VX 구/EC 불/NNG 을/JKO 잉글잉글하__1/VV 게/EC 하/VV 어/EC 보/VX 어라/EF ./SF	나무쪽 좀 더 넣어 가지고 불을 이글이글하게 해 봐라.
나르 보구 알근척두 않구 가든데요.	나/NP 르/JKO 보구/JKB 알근척__1/NNG 두/JX 않/VV 구/EC 가/VV 든데요/EF ./SF	나를 보고 알은척도 않고 가던데요.
벜에 가서 우북한 즙시르 하나만 가주와라.	벜__2/NNG 에/JKB 가/VV 어서/EC 우북하__2/VA ᆫ/ETM 즙시__1/NNG 르/JKO 하나/NR 만/JX 가주오/VV 어라/EF ./SF	부엌에 가서 우묵한 접시를 하나만 가져와라.
올챙이거 깨구리 될 때 뒷달구리부터 생기재?	올챙이/NNG 거/JKS 깨구리__1/NNG 되/VV ᆯ/ETM 때/NNG 뒷달구리__1/NNG 부터/JX 생기/VV 재/EF ?/SF	올챙이가 개구리 될 때 뒷다리부터 생기지?
“짠드럭거리지 말어라.” 꼭 그러드라구요.	“/SSO 짠드럭거리/VV 지/EC 말/VX 어라/EF ./SF ”/SSC 꼭/MAG 그러/VV 드라구요/EF ./SF	“자부락거리지 마라.” 꼭 그러더라고요.
오래전 일이라사 기억이 아사무사하다야.	오래/MAG 전/NNG 일/NNG 이/VCP 라사/EC 기억/NNG 이/JKS 아사무사하__1/VV 다야/EF ./SF	오래전 일이라서 기억이 어사무사하다야.
돈베락이 떨어진다구 해두 인심을 살 수는 웂아.	돈베락__1/NNG 이/JKS 떨어지/VV ᆫ다구/EC 하/VV 어두/EC 인심/NNG 을/JKO 살/VV ᆯ/ETM 수/NNB 는/JX 웂__1/VA 아/EF ./SF	돈벼락이 떨어진다고 해도 인심을 살 수는 없어.
사람덜이 그 아주머이 말재간에 마커 파대우임했잖소.	사람/NNG 덜/XSN 이/JKS 그/MM 아주머이__1/NNG 말/NNG 재간/NNG 에/JKB 마커__1/MAG 파대우임__1/NNG 하/XSV 었/EP 지/EC 않/VX 소/EF ./SF	사람들이 그 아주머니 말재간에 말끔 폭소했잖소.
빗잘기와 씨리박 좀 가져와라.	빗잘기__1/NNG 와/JC 씨리박__1/NNG 좀/MAG 가져오/VV 어라/EF ./SF	빗자루와 쓰레받기 좀 가져와라.
아가 울민서 자꼬 날 치다보드라구.	아__23/NNG 가/JKS 울/VV 민서/EC 자꼬__1/MAG 나/NP ᆯ/JKO 치다보__1/VV 드라구/EF ./SF	아이가 울면서 자꾸 날 쳐다보더라고.
뭘 태쾄는지 방에 연기가 꼬르리하다라.	뭐/NP ᆯ/JKO 태쿠/VV 었/EP 는지/EC 는지/EC 방/NNG 에/JKB 연기/NNG 가/JKS 꼬르리하__1/VA 다라/EF ./SF	뭘 태웠는지 방에 연기가 자욱하더라.
꼬들빼기는 심이 들아 몬 올라가.	꼬들빼기__1/NNG 는/JX 심__3/NNG 이/JKS 들/VV 아/EC 몬__3/MAG 올라가/VV 어/EF ./SF	꼭대기는 힘이 들어 못 올라가.
저 큰 돌으 짜갈라사 산에다 버레라. 	저/MM 크/VA ᆫ/ETM 돌/NNG 으/JKO 짜가르/VV 어서/EC 산/NNG 에다/JKB 버리/VV 어라/EF ./SF	저 큰 돌을 짜개서 산에다 버려라.
뭐가 그라 좋아사 해발랑 웃고 있나?	뭐/NP 가/JKS 그라/MAG 좋/VA 어사/EF 해발랑__1/MAG 웃/VV-R 고/EC 있/VX 나/EF ?/SF	뭐가 그렇게 좋아서 해발쪽 웃고 있니?
옥시끼르 잔떡 넣은 주루먹으 지구 자에 가든데요.	옥시끼__1/NNG 르/JKO 잔떡__1/MAG 넣/VV 은/ETM 주루먹__1/NNG 으/JKO 지/VV 구/EC 자__53/NNG 에/JKB 가/VV 든데요/EF ./SF	옥수수를 잔뜩 넣은 주루막을 지고 장에 가던데요.
젊었을 적에는 고만만한 어린 자석들 키우는 재미에 살었지요.	젊/VA 었/EP 을/ETM 적/NNB 에/JKB 는/JX 고만만하/VA ᆫ/ETM 어리/VA ᆫ/ETM 자석__1/NNG 들/XSN 키우/VV 는/ETM 재미/NNG 에/JKB 살/VV 었/EP 지요/EF ./SF	젊었을 적에는 고만고만한 어린 자식들 키우는 재미에 살았지요.
어제 캔 햇감재루 감재적으 좀 부칠까?	어제/MAG 캐/VV ᆫ/ETM 햇감재__1/NNG 루/JKB 감재적__1/NNG 으/JKO 좀/MAG 부치/VV ᆯ까/EF ?/SF	어제 캔 햇감자로 감자전을 좀 부칠까?
옷에 먼 얼룩이 생게서 극정으 했드니 생각보다 잘 빨리킨다.	옷/NNG 에/JKB 먼__2/MM 얼룩/NNG 이/JKS 생기/VV 어서/EC 극정__3/NNG 으/JKO 하/VV 었/EP 드니/EC 생각/NNG 보다/JKB 잘/MAG 빨리키/VV ᆫ다/EF ./SF	옷에 무슨 얼룩이 생겨서 걱정을 했더니 생각보다 잘 빨린다.
일꾼덜이 집 앞 감자밭으 건주건주 다 매 가드라.	일/NNG 꾼/XSN 덜/XSN 이/JKS 집/NNG 앞/NNG 감자/NNG 밭/NNG 으/JKO 건주건주__1/MAG 다/MAG 매/VV 어/EC 가/VX 드라/EF ./SF	일꾼들이 집 앞 감자밭을 거의거의 다 매 가더라.
사람으 깔어뭉기는 그런 못된 짓으 어데서 배웠나?	사람/NNG 으/JKO 깔어뭉기__1/VV 는/ETM 그런/MM 못되/VA ᆫ/ETM 짓/NNG 으/JKO 어데__2/NP 서/JKB 배우/VV 었/EP 나/EF ?/SF	사람을 깔아뭉개는 그런 못된 짓을 어디서 배웠니?
곰배도 벆에 불 늫구 불 담을 적에 사용하는 거지.	곰배__2/NNG 도/JX 벆__1/NNG 에/JKB 불/NNG 늫__1/VV 구/EC 불/NNG 담/VV 을/ETM 적/NNB 에/JKB 사용/NNG 하/XSV 는/ETM 거/NNB 이/VCP 지/EF ./SF	고무래도 아궁이에 불 넣고 불 담을 적에 사용하는 거지.
잘못이 있으문 말루 하지, 왜서 남어 호박새이르 잡나?	잘못/NNG 이/JKS 있/VV 으문/EC 말/NNG 루/JKB 하/VV 지/EC ,/SP 왜서/MAG 남/NNG 어/JKG 호박새이__1/NNG 르/JKO 잡/VV-R 나/EF ?/SF	잘못이 있으면 말로 하지, 왜 남의 머리채를 잡니?
올레리꼴레리, 영수는 바지에다 오줌 쌌대요.	올레리꼴레리__1/IC ,/SP 영수/NNP 는/JX 바지/NNG 에다/JKB 오줌/NNG 싸/VV 었/EP 대요/EF ./SF	알나리깔나리, 영수는 바지에다 오줌 쌌대요.
질에 가래춤으 함부루 뱉으면 안 돼.	질__4/NNG 에/JKB 가래춤__1/NNG 으/JKO 함부루__1/MAG 뱉/VV 으면/EC 안/MAG 되/VV 어/EF ./SF	길에 가래침을 함부로 뱉으면 안 돼.
지금 있는 돈은 이기 가작이다.	지금/MAG 있/VA 는/ETM 돈/NNG 은/JX 이/MM 기__76/NNB 이/JKS 가작__7/NNG 이/VCP 다/EF ./SF	지금 있는 돈은 이게 고작이다.
돈으 애낄 줄 모르면 못씬다.	돈/NNG 으/JKO 애끼/VV ᆯ/ETM 줄/NNB 모르/VV 면/EC 못씨/VV ᆫ다/EF ./SF	돈을 아낄 줄 모르면 못쓴다.
사람이 잘났다고 너무 양양대모 뵈기 싫다.	사람/NNG 이/JKS 잘나/VA 었/EP 다고/EC 너무/MAG 양양대__2/VV 모/EC 뵈/VV 기/ETN 싫/VA 다/EF ./SF	사람이 잘났다고 너무 으스대면 보기 싫다.
사나가 지지부리한 일에 신경 쓰모 못쓴다.	사나__1/NNG 가/JKS 지지부리/XR 하/XSA ᆫ/ETM 일/NNG 에/JKB 신경/NNG 쓰/VV 모/EC 못쓰/VV ᆫ다/EF ./SF	사나이가 지지한 일에 신경 쓰면 못쓴다.
가는 건딜지 말고 처레미 놔 두어라.	가/NP 는/JX 건딜__1/VV 지/EC 말/VX 고/EC 처레미__1/MAG 놓/VX 어/EC 두/VX 어라/EF ./SF	걔는 건들지 말고 그냥 놔 두어라.
젊었을 때 맨날 안팎이 갈러센다 어쩐다 하든 건넷집이 하마 손지를 봤다잖소.	젊/VA 었/EP 을/ETM 때/NNG 맨날/MAG 안팎/NNG 이/JKS 갈러세__1/VV ᆫ다/EC 어쩌/VV ᆫ다/EC 하/VV 든/ETM 건넷집__1/NNG 이/JKS 하마__3/MAG 손지__4/NNG 를/JKO 보/VV 었/EP 다/EF 하/VV 잖소/EF ./SF	젊었을 때 만날 안팎이 갈라선다 어쩐다 하던 건넛집이 벌써 손주를 봤다잖소.
참꽃이 피문 양지바른 곳에 짐이 아롱아롱 올라.	참꽃/NNG 이/JKS 피/VV 문/EC 양지바르/VA ᆫ/ETM 곳/NNG 에/JKB 짐__10/NNG 이/MM 아롱아롱/MAG 오르/VV 어/EF ./SF	참꽃이 피면 양지바른 곳에 아지랑이가 아롱아롱 올라.
눈이 침침해서 바눌구녕이 잘 안 보킨다.	눈/NNG 이/JKS 침침/XR 하/XSA 어서/EC 바눌구녕__1/NNG 이/JKS 잘/MAG 안/MAG 보키__1/VV ᆫ다/EF ./SF	눈이 침침해서 바늘구멍이 잘 안 보인다.
할머이, 올해 단우떡 잡솠어요?	할머이__1/NNG ,/SP 올해/NNG 단우떡__1/NNG 잡소__1/VV 었/EP 어요/EF ?/SF	할머니, 올해 단오떡 잡수었어요?
나으 먹고 삼질이나 하고 댕기모 못쓴다.	나으__1/NNG 먹/VV 고/EC 삼질__2/NNG 이나/JX 하/VV 고/EC 댕기/VV 모/EC 못쓰/VV ᆫ다/EF ./SF	나이 먹고 쌈질이나 하고 다니면 못쓴다.
내 종이비행기가 하날로 솟지를 않구 땅으로 강중배기했아.	나/NP 의/JKG 종이/NNG 비행기/NNG 가/JKS 하날__1/NNG 로/JKB 솟/VV-R 지/EC 를/JKO 않/VX 구/EC 땅/NNG 으로/JKB 강중배기/XR 하/XSV 었/EP 어/EF ./SF	내 종이비행기가 하늘로 솟지를 않고 땅으로 재곤두쳤어.
오랜만에 장에 나왔으니 서둘르지 말구 시느매 귀경하구 가자.	오랜만/NNG 에/JKB 장/NNG 에/JKB 나오/VV 었/EP 으니/EC 서둘르/VV 지/EC 말/VX 구/EC 시느매__1/MAG 귀경__7/NNG 하/XSV 구/EC 가/VV 자/EF ./SF	오랜만에 장에 나왔으니 서두르지 말고 천천히 구경하고 가자.
자는 어릴 때부터 사가닥질으 잘하더니 체조 선수가 됐잖소.	자/NP 는/JX 어리/VA ᆯ/ETM 때/NNG 부터/JX 사가닥질__1/NNG 으/JKO 잘/MAG 하/XSV 더니/EC 체조/NNG 선수/NNG 가/JKC 되/VV 었/EP 지/EC 않/VX 소/EC ./SF	쟤는 어릴 때부터 공중제비를 잘하더니 체조 선수가 됐잖소.
메칠 동안 청소르 못 했드니 집 안이 아주 너분지르하구나.	메칠__1/NNG 동안/NNG 청소/NNG 르/JKO 못/MAG 하/VV 었/EP 드니/EC 집/NNG 안/NNG 이/JKS 아주/MAG 너분지르하__1/VA 구나/EF ./SF	며칠 동안 청소를 못 했더니 집 안이 아주 너저분하구나.
우리 집은 지대거 높어서 아릿동네거 다 내더보케요.	우리/NP 집/NNG 은/JX 지대/NNG 거/JKS 높/VA 어서/EC 아릿동네__1/NNG 거/JKS 다/MAG 내더보키__1/VV 어요/EF ./SF	우리 집은 지대가 높아서 아랫동네가 다 내다보여요.
모심기하다가 먹는 즘숨이 그라 맛있잖소.	모심기/NNG 하/XSV 다가/EC 먹/VV 는/ETM 즘숨__1/NNG 이/JKS 그렇/VA-I 게/EC 맛있/VA 잖소/EF ./SF	모심기하다가 먹는 점심이 그렇게 맛있잖소.
니네 집 뒷산에 밤낭그가 많재?	니/NP 네/XSN 집/NNG 뒷산/NNG 에/JKB 밤낭그__1/NNG 가/JKS 많/VA 재/EF ?/SF	너네 집 뒷산에 밤나무가 많지?
어데서 이러 흘투세이거 될 때꺼지 놀았나?	어데__2/NP 서/JKB 이렇/VA-I 게/EC 흘투세이__1/NNG 거/JKC 되/VV ᆯ/ETM 때/NNG 꺼지/JX 놀/VV 었/EP 나/EC ?/SF	어디서 이렇게 흙투성이가 될 때까지 놀았니?
이번 태풍 때민에 낭기가 부라졌잖소.	이번/NNG 태풍/NNG 때민__1/NNB 에/JKB 낭기__1/NNG 가/JKS 부라지__1/VV 었/EP 지/EC 않/VX 소/EC ./SF	이번 태풍 때문에 나무가 부러졌잖소.
너머 쏘댕기지만 말구 진득하게 앉어서 공부 좀 해라.	너머__2/MAG 쏘댕기__1/VV 지만/EC 말/VX 구/EC 진득/XR 하/XSA 게/EC 앉/VV 어서/EC 공부/NNG 좀/MAG 하/VV 어라/EF ./SF	너무 쏘다니지만 말고 진득하게 앉아서 공부 좀 해라.
속이 안 좋은지 자꾸 꿱질이 나와.	속/NNG 이/JKS 안/MAG 좋/VA 은지/EC 자꾸/MAG 꿱질__1/NNG 이/JKS 나오/VV 어/EF ./SF	속이 안 좋은지 자꾸 구역질이 나와.
일할 때 매사 빈틈이 없는 기 꼭 차돌이다라. 	일/NNG 하/XSV ᆯ/ETM 때/NNG 매사/MAG 빈틈/NNG 이/JKS 없/VA 는/ETM 기__76/NNB 이/JKS 꼭/MAG 차돌/NNG 이/VCP 다라/EF ./SF	일할 때 매사 빈틈이 없는 게 꼭 차돌이더라.
마누라 몰르게 꽁쳐 둔 돈으루 술 한잔 걸쳈아.	마누라/NNG 몰르__2/VV 게/EC 꽁치__1/VV 어/EC 두/VV ᆫ/ETM 돈/NNG 으루/JKB 술/NNG 한/MM 잔/NNG 걸치/VV 었/EP 어/EF ./SF	마누라 모르게 꿍쳐 둔 돈으로 술 한잔 걸쳤어.
왜 이러 얼굴이 모씨게 됐소.	왜/MAG 이렇/VA-I 게/EC 얼굴/NNG 이/JKS 모씨__1/VV 게/EC 되/VV 었/EP 소/EC ./SF	왜 이렇게 얼굴이 못쓰게 됐소.
어제 음석을 잘못 먹었더니 속이 대루와서 혼났아.	어제/MAG 음석__1/NNG 을/JKO 잘/MAG 못/MAG 먹/VV 었/EP 더니/EC 속/NNG 이/JKS 대릅__1/VA-I 어서/EC 혼나/VV 었/EP 어/EF ./SF	어제 음식을 잘못 먹었더니 속이 메스꺼워서 혼났어.
하루 죙일 뙤댕기드니 배고프재?	하루/NNG 죙일__1/NNG 뙤댕기__1/VV 드니/EC 배고프/VA 재/EF ?/SF	하루 종일 뛰어다니더니 배고프지?
사티기가 자꾸 씨닥거레서 씨라린다.	사티기__1/NNG 가/JKS 자꾸/MAG 씨닥거리__1/VV 어서/EC 씨라리__1/VA ᆫ다/EF ./SF	사타구니가 자꾸 쓸려서 쓰라린다.
가가 하는 말은 수완 거짓말이다라.	가/NP 가/JKS 하/VV 는/ETM 말/NNG 은/JX 수완__3/MAG 거짓말/NNG 이/VCP 다라/EF ./SF	걔가 하는 말은 순 거짓말이더라.
내 말뜻은 그기 아이다.	나/NP 의/JKG 말뜻/NNG 은/JX 그기/NP 이/JKC 아이__1/VA 다/EF ./SF	내 말뜻은 그게 아니다.
어제는 너무 심이 들었는지 꾸시레져서 아칙까지 잤잖소.	어제/NNG 는/JX 너무/MAG 심__3/NNG 이/JKS 들/VV 었/EP 는지/EC 꾸시레지__1/VV 어서/EC 아칙__1/NNG 까지/JX 자/VV 었/EP 잖소/EF ./SF	어제는 너무 힘이 들었는지 쓰러져서 아침까지 잤잖소.
겅굼대로 빨랫줄으 높이 올려라.	겅굼대__1/NNG 로/JKB 빨랫줄/NNG 으/JKO 높이/MAG 올리/VV 어라/EF ./SF	바지랑대로 빨랫줄을 높이 올려라.
누가 이러 방으 매렌읎이 어질고 놓구 갔나?	누구/NP 가/JKS 이렇/VA-I 게/EC 방/NNG 으/JKO 매렌읎__1/VA 이/EC 어질__2/VV 고/EC 놓/VV 구/EC 가/VV 었/EP 나/EF ?/SF	누가 이렇게 방을 형편없이 어질러 놓고 갔니?
엄마 팔비개 비구 코자자.	엄마/NNG 팔비개__1/NNG 비__13/VV 구/EC 코자__1/VV 자/EF ./SF	엄마 팔베개 베고 코하자.
마누래한테 쥐케사는 것처름 말해두, 그 집 부부 금실은 말두 못하게 좋아.	마누래__1/NNG 한테/JKB 쥐케살__1/VV 는/ETM 것/NNB 처름/JKB 말/NNG 하/XSV 어두/EC ,/SP 그/MM 집/NNG 부부/NNG 금실/NNG 은/JX 말/NNG 두/JX 못/MAG 하/VV 게/EC 좋/VA 어/EF ./SF	마누라한테 쥐여사는 것처럼 말해도, 그 집 부부 금실은 말도 못하게 좋아.
봄철 반찬으루는 씹씨레한 산나물이 젤이야.	봄철/NNG 반찬/NNG 으루/JKB 는/JX 씹씨레/XR 하/XSA ᆫ/ETM 산나물/NNG 이/JKS 젤__1/NNG 이/VCP 야/EF ./SF	봄철 반찬으로는 씁쓰레한 산나물이 젤이야.
비도 추적추적 오는데 오늘 즘심에는 부치미르 부체 먹자.	비/NNG 도/JX 추적추적/MAG 오/VV 는데/EC 오늘/NNG 즘심__1/NNG 에/JKB 는/JX 부치미__1/NNG 르/JKO 부치/VV 어/EC 먹/VV 자/EF ./SF	비도 추적추적 오는데 오늘 점심에는 부침개를 부쳐 먹자.
우리 말은 사방으루 산이 맥헤 있어서 저울철에두 참 안득해요.	우리/NP 말__26/NNG 은/JX 사방/NNG 으루/JKB 산/NNG 이/JKS 맥히__1/VV 어/EC 있/VX 어서/EC 저울철__1/NNG 에/JKB 두/JX 참/MAG 안득/XR 하/XSA 어요/EF ./SF	우리 마을은 사방으로 산이 막혀 있어서 겨울철에도 참 아늑해요.
옛날이나 지끔이나 무조근 냉게눌룬다고 사램들이 순순히 따르겠소?	옛날/NNG 이나/JC 지끔__2/NNG 이나/JC 무조근__1/NNG 냉게눌루__1/VV ᆫ다고/EC 사램__1/NNG 들/XSN 이/JKS 순순히/MAG 따르/VV 겠/EP 소/EF ?/SF	옛날이나 지금이나 무조건 내리누른다고 사람들이 순순히 따르겠소?
장마철이라 어디서 코다부리한 내금새가 난다야.	장마철/NNG 이/VCP 라/EC 어디/NP 서/JKB 코다부리/XR 하/XSA ᆫ/ETM 내금새__1/NNG 가/JKS 나/VV ᆫ다야/EF ./SF	장마철이라 어디서 퀴퀴한 냄새가 나는구나.
자전게르 끌구 던들배기질으 올라왔으이 심들기두 하겠다.	자전게__1/NNG 르/JKO 끌/VV 구/EC 던들배기질__1/NNG 으/JKO 올라오/VV 었/EP 으이/EC 심들__1/VA 기/ETN 두/JX 하/VX 겠/EP 다/EF ./SF	자전거를 끌고 언덕길을 올라왔으니 힘들기도 하겠다.
무렆으 꿇구 앉어 있었드니 다리거 제리제리해.	무렆__1/NNG 으/JKO 꿇/VV 구/EC 앉/VV 어/EC 있/VX 었/EP 드니/EC 다리/NNG 거/JKS 제리제리__1/MAG 하/XSA 어/EF ./SF	무릎을 꿇고 앉아 있었더니 다리가 저리저리해.
옛날에는 산에 가서 깍쟁이질으 해서 소갈비르 끌어 왔아.	옛날/NNG 에/JKB 는/JX 산/NNG 에/JKB 가/VV 어서/EC 깍쟁이질__1/NNG 으/JKO 하/XSV 어서/EC 소갈비__2/NNG 르/JKO 끌/VV 어/EC 오/VX 었/EP 어/EF ./SF	옛날에는 산에 가서 갈퀴질을 해서 솔가리를 끌어 왔어.
자들은 따치 떨어져 댕게야 안 시꾸룹다.	자/NP 들/XSN 은/JX 따치__2/MAG 떨어지/VV 어/EC 댕기__2/VV 어야/EC 안/MAG 시꾸룹__1/VA-I 다/EF ./SF	쟤들은 따로 떨어져 다녀야 안 시끄럽다.
남 보구 함부루 꼴불겐이라구 그러문 못써.	남/NNG 보/VV 구/EC 함부루__1/MAG 꼴불겐__1/NNG 이/VCP 라구/EC 그러/VV 문/EC 못/MAG 쓰/VV 어/EF ./SF	남 보고 함부로 꼴불견이라고 그러면 못써.
