네 동미덜으느 어띠 다 밉은양하냐? 	네/IC 동미__1/NNG 덜/XSN 으/JKG 느/NP 어띠__1/MAG 다/MAG 밉은양하__1/VA-I 냐/EF ?/SF	네 동무들은 어찌 다 밉살스럽냐? 	너/NP 의/JKG 동무/NNG 들/XSN 은/JX 어찌/MAG 다/MAG 밉살스럽/VA-I 냐/EF ?/SF
붕어 홰가 화어 홰두 맛잇구 잉에두 홰를 맨들어 먹으무 맛이 잇습지.	붕어/NNG 홰/NNG 가/JKS 화어/NNG 홰/NNG 두/MM 맛/NNG 잇/VV-I 구/EC 잉에__2/NNG 두/MM 홰/NNG 를/JKO 맨들/VV 어/EC 먹/VV 으/EF 무/NNG 맛/NNG 이/JKS 잇/NNG 습지/NNG ./SF	붕어 회와 황어 회도 맛있고 잉어도 회를 만들어 먹으면 맛이 있지요.	붕어/NNG 회/NNG 와/JC 황어/NNP 회/NNG 도/JX 맛있/VA 고/EC 잉어/NNG 도/JX 회/NNG 를/JKO 만들/VV 어/EC 먹/VV 으면/EC 맛/NNG 이/JKS 있/VV 지요/EF ./SF
내 애끼두 헴우 잘 쳇습구마. 	내/MM 애끼두/NNG 헴__6/NNG 우/NNG 잘/MAG 쳇습구마/NNG ./SF	내 동생도 헤엄을 잘 쳤습니다. 	내/MM 동생/NNG 도/JX 헤엄/NNG 을/JKO 잘/MAG 치/VV 었/EP 습니다/EF ./SF
올채이 크무 메그락지 댑구마.	올채이__1/NNG 크무/NNG 메그락지__1/NNG 댑구마/NNG ./SF	올챙이가 크면 개구리가 됩니다.	올챙이/NNG 가/JKS 크/VA 면/EC 개구리/NNG 가/JKC 되/VV ᆸ니다/EF ./SF
이 짐이사 개가웁구 기래니 내 들구 가갯소.	이/MM 짐/NNG 이/JKS 사/NR 개가웁__1/VA-I 구/EC 기래/NNG 이/VCP 니/EC 나/NP 의/JKG 들/VV 구/EC 가/VV 어/EC 개/VV 엇/EP 소/EC ./SF	이 짐이야 가볍고 그러니 내가 들고 가겠소.	이/MM 짐/NNG 이야/JX 가볍/VA-I 고/EC 그렇/VA-I 니/EC 나/NP 가/JKS 들/VV 고/EC 가/VV 겠/EP 소/EC ./SF
가비 얼매나 섧은지 나날이 웁구마. 	가비__5/NNG 얼매__1/NNG 나/JX 섧/VA 은지/EC 나날이/MAG 웁구마/NNG ./SF	과부가 얼마나 설운지 나날이 웁니다. 	과부/NNG 가/JKC 얼마나/MAG 설/NNG 울/VV ᆫ지/EC 나날이/MAG 울/VV ᆸ니다/EF ./SF
그거 어띃게 먹슴까?	그거/NP 어띃게__1/MAG 먹슴까/NNG ?/SF	그거 어찌 먹습니까?	그거/NP 어찌/MAG 먹/VV 습니까/EF ?/SF
영게 옥시끼 많이 있소.	영게__1/NP 옥시끼__1/NNG 많이/MAG 있/VA 소/EC ./SF	여기 옥수수가 많이 있소.	여기/NP 옥수수/NNG 가/JKS 많이/MAG 있/VV 소/EC ./SF
아덜이 디렵다 달아간다.	아__23/NNG 덜/XSN 이/JKS 디렵다__1/MAG 닫/VV-I 어/EC 가/VX ᆫ다/EF ./SF	아이들이 들입다 달려간다.	아이/NNG 들/XSN 이/JKS 들입다/MAG 달려가/VV ᆫ다/EF ./SF
아덜으느 꼼치울래기하구 놀다 나니 저골고롬이 잘 떨어디대니우?	$$$ 아덜으느/NNG 꼼치울래기하구/NNG 놀/VV 다/EC 나/VX 니/EC 저/MM 골/VV 고/EC 롬/NNG 이/JKS 잘/MAG 떨어디대니우/NNG ?/SF	아이들은 숨바꼭질하고 놀다 보니 옷고름이 잘 떨어지지 않소?
그 동미 간대사 나르 얼렛갯슴둥? 	그/MM 동미__1/NNG 간대사__1/MAG 나/NP 르/NNG 얼렛갯슴둥/NNG ?/SF	그 동무가 설마 나를 속였겠습니까? 	그/MM 동무/NNG 가/JKS 설마/MAG 나/NP 를/JKO 속이/VV 었/EP 겠/EP 습니까/EF ?/SF
지끔꺼지두 샐르 짐스으 잡소.	지끔__2/NNG 꺼지/VV 두/JX 샐르/NNG 짐스__1/NNG 으/JKG 잡/VV-R 소/EC ./SF	지금까지도 올가미로 짐승을 잡소.	지금/NNG 까지/JX 도/JX 올가미/NNG 로/JKB 짐승/NNG 을/JKO 잡/VV-R 소/EC ./SF
가꼴막에 낭그들이 가뜩하다.	가꼴막__1/NNG 에/JKB 낭그__1/NNG 들/XSN 이/JKS 가뜩/MAG 하/XSA 다/EF ./SF	언덕바지에 나무들이 가득하다.	언덕바지/NNG 에/JKB 나무/NNG 들/XSN 이/JKS 가득/MAG 하/XSA 다/EF ./SF
뇰으 주무 달기 닭으덩때에서 네레와서 인차 먹습구마. 	뇰__1/NNG 으/JKG 주무/NNG 달/VV 기/ETN 닭으덩때__1/NNG 에서/JKB 네레/NNG 오/VV 어서/EC 인차/NNG 먹/VV 습/NNG 구마/EF ./SF	모이를 주면 닭이 홰에서 내려와서 이내 먹습니다. 	모이/NNG 를/JKO 주/VV 면/EC 닭/NNG 이/JKS 홰/NNG 에서/JKB 내려오/VV 어서/EC 이내/MAG 먹/VV 습니다/EF ./SF
어제께 개굴에서 괴기잽이를 해 가미 놀앗습구마.	어제/MAG 께/JKB 개/NNG 굴/NNG 에서/JKB 괴기잽이__1/NNG 를/JKO 하/VV 어/EC 가미/NNG 놀/VV 엇/EF 습/NNG 구마/EF ./SF	어저께 개울에서 고기잡이를 해 가며 놀았습니다.	어저께/MAG 개울/NNG 에서/JKB 고기잡이/NNG 를/JKO 하/VV 어/EC 가/VX 며/EC 놀/VV 었/EP 습니다/EF ./SF
할기 좋대니무 농새 잘 아이 뎁구마. 	$$$ 하/VV ᆯ/ETM 기/NNB 좋/VA 대/EF 니/MM 무/XPN 농/NNG 새/MM 잘/MAG 아이/IC 뎁구마/NNG ./SF	흙이 좋지 않으면 농사가 잘 안 됩니다. 
저 동미느 제깍하무 다배집구마. 	저/MM 동미__1/NNG 느/NP 제깍하무__1/MAG 다/MAG 배/NNG 집/NNG 구마/EF ./SF	저 동무는 걸핏하면 자빠집니다.	저/NP 동무/NNG 는/JX 걸핏하면/MAG 자빠지/VV ᆸ니다/EF ./SF
해르 바라본다구 하는 그 꽂이 바루 해가부리지.	해르/NNG 바라보/VV ᆫ다구/EC 하/VV 는/ETM 그/MM 꽂__1/NNG 이/JKS 바루/MAG 해가부리__1/NNG 이/VCP 지/EF ./SF	해를 바라본다고 하는 그 꽃이 바로 해바라기지.	해/NNG 를/JKO 바라보/VV ᆫ다고/EC 하/VV 는/ETM 그/MM 꽃/NNG 이/JKS 바로/MAG 해바라기/NNG 이/VCP 지/EF ./SF
우리 집 도티느 너무 때부시해서 걷지르 못합구마. 	우리/NP 집/NNG 도티__1/NNG 느/NP 너무/MAG 때부시/NNG 하/XSA 어서/EC 걷지르/NNG 못/MAG 합/NNG 구마/EF ./SF	우리 집 돼지는 너무 살쪄서 걷지를 못합니다. 	우리/NP 집/NNG 돼지/NNG 는/JX 너무/MAG 살찌/VV 어서/EC 걷/VV-I 지/EC 를/JX 못하/VX ᆸ니다/EF ./SF
아르 녚구레 끼구 있습더구마.	아__23/NNG 르/NNG 녚구레/NNG 끼/VV 구/EC 있/VX 습/NNG 더/MAG 구마/EF ./SF	아이를 옆구리에 끼고 있더군요.	아이/NNG 를/JKO 옆구리/NNG 에/JKB 끼/VV 고/EC 있/VX 더군요/EF ./SF
명이 길댸닣구 따른 사름이 잇갯습지.	$$$ 명/NNG 이/JKS 길댸닣구/NNG 따르/VV ᆫ/ETM 사르/VV ᆷ/ETN 이/JKS 잇갯습/NNG 이/VCP 지/EF ./SF	명이 길지 않고 짧은 사람이 있겠지요.
밭으르 나가 일으 하자무 헤미느 꼭 잇어야 합구마. 	밭/NNG 으르/VV 나가/VX 어/EC 일/NNG 으/JKG 하/VV 자/EC 무/NNG 헤미__2/NNG 느/NP 꼭/MAG 잇/VV-I 어야/EC 합/NNG 구마/EF ./SF	밭으로 나가 일을 하자면 호미는 꼭 있어야 합니다. 	밭/NNG 으로/JKB 나가/VV 어/EC 일/NNG 을/JKO 하/VV 자면/EC 호미/NNG 는/JX 꼭/MAG 있/VV 어야/EC 하/VX ᆸ니다/EF ./SF
헤때기 아프무 약으 바르구야 그 벼이 떨어집지. 	헤때기__1/NNG 아프무/NNG 약/NNG 으/JKG 바르/VV 구/EC 야/JX 그/MM 벼이/NNG 떨/VV 어/EC 집/VV-R 지/EF ./SF	혀때기가 아프면 약을 발라야 그 병이 낫지요. 	혀때기/NNG 가/JKS 아프/VA 면/EC 약/NNG 을/JKO 바르/VV 어야/EC 그/MM 병/NNG 이/JKS 낫/VV-I 지요/EF ./SF
어시게 불효햇다구 가깝은 친첵이 아들 빰나가지르 내갈겟습구마. 	어시__1/NNG 이/VCP 게/EC 불효/NNG 하/XSV 엇/EP 다구/EC 가깝/VA-I 은/ETM 친첵/NNP 이/JKS 아들/NNG 빰나가지__1/NNG 르/NNG 내가/VV ᆯ/ETM 겟/EP 습/NNG 구마/EF ./SF	어버이에게 불효했다고 가까운 친척이 아들 뺨따귀를 내갈겼습니다. 	어버이/NNG 에게/JKB 불효/NNG 하/XSV 었/EP 다고/EC 가깝/VA-I 은/ETM 친척/NNG 이/JKS 아들/NNG 뺨따귀/NNG 를/JKO 내/VV 어/EC 갈기/VV 었/EP 습니다/EF ./SF
쌈우 하무 치우라 이게라구 말합지.	쌈/NNG 우/NNG 하/NNG 무/NNG 치우/VV 라/EC 이게__1/VV 라구/EF 말/NNG 합/NNG 지/EF ./SF	쌈을 하면 반드시 이기라고 말하지요.	쌈/NNG 을/JKO 하/VV 면/EC 반드시/MAG 이기/VV 라고/EC 말/NNG 하/XSV 지요/EF ./SF
엊저낙에 웨삼춘댁 상새 낫다구 전홰 왓습구마.	$$$ 엊저낙/NNP 에/JKB 웨/NNP 삼춘/NNG 댁/XSN 상/NNG 새/MM 낫/VA-I 다구/EC 전/MM 홰/NNG 오/VV 엇/EP 습/NNG 구마/EF ./SF	엊저녁에 외삼촌댁 돌아가셨다고 전화가 왔습니다.
우리 아들으느 핵교서 꼬래비만 함메.	우리/NP 아들/NNG 으/JKG 느/NP 핵교__1/NNG 서/JKB 꼬래비__1/NNG 만/JX 함/NNG 메/VV 어/EF ./SF	우리 아들은 학교에서 꼴찌만 하네.	우리/NP 아들/NNG 은/JX 학교/NNG 에서/JKB 꼴찌/NNG 만/JX 하/VV 네/EF ./SF
아즈바니께 슈갑 빌게 디레라.	아즈바니께/NNG 슈갑__1/NNG 빌/VV 게/EC 디레/NNG 이/VCP 라/EF ./SF	고모부께 장갑 빌려 드려라.	고모부/NNG 께/JKB 장갑/NNG 빌리/VV 어/EC 드리/VX 어라/EF ./SF
내게사 아들가 딸 둘 다 딱같은 자석입구마.	나/NP 에게/JKB 사/NR 아들/NNG 가/VV 어/EC 딸/NNG 둘/NR 다/MAG 딱같__1/VA 은/ETM 자석/NNG 입/VV-R 구마/EF ./SF	내게야 아들과 딸 둘 다 똑같은 자식입니다.	나/NP 에게/JKB 야/JX 아들/NNG 과/JC 딸/NNG 둘/NR 다/MAG 똑같/VA 은/ETM 자식/NNG 이/VCP ᆸ니다/EF ./SF
도투 줴에다 굴에 옇어라.	도투__1/NNG 줴/NNG 에다/JKB 굴__10/NNG 에/JKB 옇__1/VV 어라/EF ./SF	돼지를 잡아다 우리에 넣어라.	돼지/NNG 를/JKO 잡/VV-R 어다/EC 우리/NNG 에/JKB 넣/VV 어라/EF ./SF
자는 어째서 뜬뜬해서 저러고 있슴메?	자/VV 는/ETM 어째서/MAG 뜨/VV ᆫ/ETM 뜨/VV ᆫ/ETM 하/XSV 어서/EC 저러/VV 고/EC 있슴메/NNG ?/SF	쟤는 어째서 뚱해서 저러고 있는가?	쟤/NP 는/JX 어째서/MAG 뚱하/VA 어서/EC 저러/VV 고/EC 있/VX 는가/EF ?/SF
호분차 먹기 슳에서 시걱때두 밥으 잘 아이 먹엇습구마. 	호분차__1/NNG 먹/VV 기/ETN 슳__1/VA 에서/JKB 시걱__1/NNG 때/NNG 두/JX 밥/NNG 으/NNG 잘/MAG 아이/NNG 먹/VV 엇/EP 습/NNG 구마/EF ./SF	혼자 먹기 싫어서 끼니때에도 밥을 잘 먹지 않았습니다. 	혼자/NNG 먹/VV 기/ETN 싫/VA 어서/EC 끼니/NNG 때/NNG 에/JKB 도/JX 밥/NNG 을/JKO 잘/MAG 먹/VV 지/EC 않/VX 었/EP 습니다/EF ./SF
오쿠리메 댕기지 말구 가슴우 쭉 페구 댕게라.	오쿠리__1/VV 메/NNG 댕기__2/VV 지/EC 말/VX 구/EC 가슴/NNG 우/NNG 쭉/MAG 페구/NNG 댕게라/NNG ./SF	오그리며 다니지 말고 가슴을 쭉 펴고 다녀라.	오그리/VV 며/EC 다니/VV 지/EC 말/VX 고/EC 가슴/NNG 을/JKO 쭉/MAG 펴/VV 고/EC 다니/VV 어라/EF ./SF
댜느 기애짓 아들 왜사춘이랍데.	$$$ 댜느/NNG 기애짓/NNG 아들/NNG 왜사춘이랍데/NNG ./SF	저 애는 기와집 아들 외사촌이라데.
개 세띨르 물으 핧아 먹습구마. 	개/NNG 세띨르/NNG 물/NNG 으/JKG 핧아/NNG 먹/VV 습/NNG 구마/EF ./SF	개가 혀로 물을 핥아 먹습니다. 	개/NNG 가/JKS 혀/NNG 로/JKB 물/NNG 을/JKO 핥/VV 어/EC 먹/VV 습니다/EF ./SF
도투 잡우무 념티르 나르 주우.	도투__1/NNG 잡/VV-R 우/EC 무/XPN 념티__1/NNG 르/NNG 나르/VV 주/VV 우/EF ./SF	돼지를 잡으면 염통을 나를 주오.	돼지/NNG 를/JKO 잡/VV-R 으면/EC 염통/NNG 을/JKO 나/NP 를/JKO 주/VV 오/EF ./SF
우리 집으르 하냥 같이 가기오. 	우리/NP 집/NNG 으르/VV 하냥__3/MAG 같이/MAG 가/VV 기/ETN 이/VCP 오/EF ./SF	우리 집으로 꼭 같이 가세. 	우리/NP 집/NNG 으로/JKB 꼭/MAG 같이/MAG 가/VV 세/EF ./SF
깔으 한 움쾜 줴 오오.	깔__3/NNG 으/JKG 한/MM 움쾜__1/NNB 줴/NNG 오오/IC ./SF	꼴을 한 움큼 쥐어 오오.	꼴/NNG 을/JKO 한/MM 움큼/NNB 쥐/VV 어/EC 오/VX 오/EF ./SF
아이구! 발에서 발똥쿠린내 나니까데 싹 싳어라.	아이구/IC !/SF 발/NNG 에서/JKB 발똥쿠린내__1/NNG 나/VV 니까/EC 데/NNB 싹/MAG 싳/NNG 어라/EF ./SF	아이고! 발에서 고린내가 나니까 싹 씻어라.	아이고/IC !/SF 발/NNG 에서/JKB 고린내/NNG 가/JKS 나/VV 니까/EC 싹/MAG 씻/VV-R 어라/EF ./SF
낭그르 불러뜨려서 지팽이를 맨들었수다레.	낭그__1/NNG 르/NNG 부르/VV 어/EC 뜨리/XSV 어서/EC 지/NP 팽이/NNG 를/JKO 맨들/VV 었/EP 수다/EF 레/NNG ./SF	나무를 부러뜨려서 지팡이를 만들었습니다.	나무/NNG 를/JKO 부러뜨리/VV 어서/EC 지팡이/NNG 를/JKO 만들/VV 었/EP 습니다/EF ./SF
저낙 먹을 때 됏는데 웨아즈바이느 안즉 아이 왓슴둥?	저낙__1/NNG 먹/VV 을/ETM 때/NNG 되/VV 엇/EP 는데/EC 웨아즈바이__1/NNG 느/NP 안즉/MAG 아이/NNG 왓슴둥/NNG ?/SF	저녁 먹을 때 됐는데 외삼촌은 아직 안 왔습니까?	저녁/NNG 먹/VV 을/ETM 때/NNG 되/VV 었/EP 는데/EC 외삼촌/NNG 은/JX 아직/MAG 안/MAG 오/VV 었/EP 습니까/EF ?/SF
둥굴소르 가대기에 메와서 밭으 갈앗습지. 	둥굴소__1/NNG 르/NNG 가/JKS 대기/NNG 에/JKB 메/NNG 오/VV 어서/EC 밭/NNG 으/JKG 갈/VV 엇/EF 습지/NNG ./SF	황소를 가대기에 메워서 밭을 갈았지요.	황소/NNG 를/JKO 가/VV 어/EC 대기/NNG 에/JKB 메우/VV 어서/EC 밭/NNG 을/JKO 갈/VV 었/EP 지요/EF ./SF
댱기르 동생게 갲다 줘라.	댱기__1/NNG 르/NNG 동생/NNG 게/EC 갲다/NNG 주/VV 어라/EF ./SF	장구를 동생에게 갖다 줘라.	장구/NNG 를/JKO 동생/NNG 에게/JKB 갖/VV 다/EC 주/VX 어라/EF ./SF
돈으 쪼꼼이라두 해잴하무 안 된다.	돈/NNG 으/JKG 쪼꼼__1/NNG 이/VCP 라두/EC 해잴하__1/VV 무/NNG 안/MAG 되/VV ᆫ다/EF ./SF	돈을 조금이라도 낭비하면 안 된다.	돈/NNG 을/JKO 조금/NNG 이/VCP 라도/EC 낭비/NNG 하/XSV 면/EC 안/MAG 되/VV ᆫ다/EF ./SF
아덜이 헤태르 내밀메 웃구 그러무 어시느 귀엽다구 그 아르 안아 줍구마. 	아__23/NNG 덜/XSN 이/JKS 헤태__1/NNG 르/NNG 내밀/VV ᆯ/ETM 메/NNG 웃/VV-R 구/EC 그러/VV 어/EF 무/NNG 어시느/NNG 귀엽/VA-I 다구/EF 그/MM 아__23/NNG 르/NNG 안/VV 어/EC 줍/VV-I 구/EC 말/VX 어/EF ./SF	아이들이 혀를 내밀며 웃고 그러면 부모는 귀엽다고 그 아이를 안아 줍니다. 	아이/NNG 들/XSN 이/JKS 혀/NNG 를/JKO 내밀/VV 며/EC 웃/VV-R 고/EC 그러/VV 면/EC 부모/NNG 는/JX 귀엽/VA-I 다고/EC 그/MM 아이/NNG 를/JKO 안/VV 어/EC 주/VX ᆸ니다/EF ./SF
우리 아느 새박부터 부지러이 배아리 들구 놀러 나갔소.	우리/NP 아느/NNP 새박__3/NNG 부터/JX 부지러이/NNP 배아리__2/NNG 들/VV 구/EC 놀/VV 러/EC 나가/VV 었/EP 소/EC ./SF	우리 애는 새벽부터 부지런히 팽이 들고 놀러 나갔소.	우리/NP 애/NNG 는/JX 새벽/NNG 부터/JX 부지런히/MAG 팽이/NNG 들/VV 고/EC 놀/VV 러/EC 나가/VV 었/EP 소/EC ./SF
내 쓴 펜지에 홰답으 아이 주다 나니까데 서분합구마. 	나/NP 의/JKG 쓰/VV ᆫ/ETM 펜/NNG 지/NNG 에/JKB 홰답__1/NNG 으/JKG 아이/NNG 주/VV 다/EC 나/VX 니까/EC 데/NNB 서/NNG 분합/NNG 구마/EF ./SF	내가 쓴 편지에 회답을 주지 않다 보니까 서운합니다.	나/NP 가/JKS 쓰/VV ᆫ/ETM 편지/NNG 에/JKB 회답/NNG 을/JKO 주/VV 지/EC 않/VX 다/EC 보/VX 니까/EC 서운/XR 하/XSA ᆸ니다/EF ./SF
소낙 소리 쎄기 나는 게 인차 비 오갯습구마.	소낙__1/NNG 소리/NNG 쎄/VA 기/ETN 나/VV 는/ETM 것/NNB 이/JKS 인차/NNG 비/NNG 오갯습구마/NNG ./SF	우레 소리 세게 나는 게 이내 비 오겠습니다.	우레/NNG 소리/NNG 세/VA 게/EC 나/VV 는/ETM 것/NNB 이/JKS 이내/MAG 비/NNG 오/VV 겠/EP 습니다/EF ./SF
우춧한 사름이사 세사에 많갯습지. 	우춧/NNG 한/MM 사름__2/NNG 이/JKS 사/NR 세/NNB 사/NR 에/JKB 많갯/NNG 습지/NNG ./SF	어리석은 사람이야 세상에 많겠지요. 	어리석/VA 은/ETM 사람/NNG 이/VCP 야/EF 세상/NNG 에/JKB 많/VA 겠/EP 지요/EF ./SF
밭에 무끼가 배채르 세이 싱것습구마. 	밭/NNG 에/JKB 무끼__1/NNG 가/JKS 배채__1/NNG 르/NNG 세이__3/MAG 싱/NNP 것/NNB 습/NNG 구마/EF ./SF	밭에 무와 배추를 많이 심었습니다.	밭/NNG 에/JKB 무/NNG 와/JC 배추/NNG 를/JKO 많이/MAG 심/VV 었/EP 습니다/EF ./SF
승겁운가 짭운가 맛으 보오.	승/NNG 겁/NNG 운/NNG 가/XSN 짭/NNG 운/NNG 가/XSN 맛/NNG 으/JKG 보/VV 오/EF ./SF	싱거운가 짠가 맛을 보오.	싱겁/VA-I 은가/EF 짜/VA ᆫ가/EF 맛/NNG 을/JKO 보/VV 오/EF ./SF
곤매시르 닦아 먹으무 과연 맛잇습지. 	곤매시__1/NNG 르/NNG 닦/VV 어/EC 먹/VV 으/EF 무/XPN 과연/MAG 맛/NNG 잇/VV-I 습지/NNG ./SF	호박을 볶아 먹으면 정말 맛있지요. 	호박/NNG 을/JKO 볶/VV 어/EC 먹/VV 으면/EC 정말/MAG 맛있/VA 지요/EF ./SF
저 아느 제 어시 말으 통 듣댸이쿠 펀한 짓만 하구 댕긴다구 합구마.	$$$ 저/IC 아느/NNG 저/NP 의/JKG 어/IC 시/NNG 말/NNG 으/JKG 통/NNG 듣댸이쿠/NNG 펀/NNG 하/XSA ᆫ/ETM 짓/NNG 만/JX 하/VV 구/EC 댕기/VV ᆫ다구/EF 합/NNG 구마/EF ./SF	저 아이는 제 부모 말을 통 듣지 않고 멍청한 짓만 하고 다닌다고 합니다.
핵교서 아덜 배와주는 선생님덜 보무 바쁜 가툴합구마.	$$$ 핵교/NNG 서/JKB 아/NNG 덜/XSN 배/NNG 와/JC 주/VV 는/ETM 선생/NNG 님/XSN 덜/XSN 보무/NNG 바쁘/VA ᆫ/ETM 가툴합구마/NNG ./SF	학교에서 아이들 가르치는 선생님들 보면 어려운 것 같습니다. 
당신이 그래셔 나두 그 사람이 쇠겡이인 줄로만 알았습구마.	당신/NP 이/JKS 그렇/VA-I 어/EC 시/EP 어/EC 나/NP 두/JX 그/MM 사람/NNG 이/JKS 쇠겡이__1/NNG 이/VCP ᆫ/ETM 줄/NNB 로/JKB 만/JX 알/VV 었/EP 습/NNG 구마/EF ./SF	당신이 그래서 나도 그 사람이 소경인 줄로만 알았습니다.	당신/NP 이/JKS 그래서/MAJ 나/NP 도/JX 그/MM 사람/NNG 이/JKS 소경/NNG 이/VCP ᆫ/ETM 줄/NNB 로/JKB 만/JX 알/VV 었/EP 습니다/EF ./SF
내 고향 경흥가 저짝 단천 말테 땁구마. 	나/NP 의/JKG 고향/NNG 경흥/NNP 가/NNG 저짝__1/NP 단/NNG 천/NNG 말테__1/NNG 땁구마/NNG ./SF	내 고향 경흥과 저쪽 단천 말투가 다릅니다. 	나/NP 의/JKG 고향/NNG 경흥/NNP 과/JC 저쪽/NP 단/NNG 천/NNG 말투/NNG 가/JKS 다르/VA ᆸ니다/EF ./SF
일으 많이 하다 나니 오분몸이 다 아파서 못 살갯습구마.	일/NR 으/NNG 많이/MAG 하/VV 다/EC 나/VX 니/EC 오분몸__1/NNG 이/JKS 다/MAG 아프/VA 어서/EC 못/MAG 살/VV 개/VV 엇/EP 습/NNG 구마/EF ./SF	일을 많이 하다 보니 온몸이 다 아파서 못 살겠습니다.	일/NNG 을/JKO 많이/MAG 하/VV 다/EC 보/VX 니/EC 온몸/NNG 이/JKS 다/MAG 아프/VA 어서/EC 못/MAG 살/VV 겠/EP 습니다/EF ./SF
아바이, 소곰쟁이 잡지 맙소.	아바이/NNP ,/SP 소곰쟁이__1/NNG 잡/VV-R 지/EC 맙소/NNG ./SF	아버지, 잠자리 잡지 마십시오.	아버지/NNG ,/SP 잠자리/NNG 잡/VV-R 지/EC 말/VX 시/EP ᆸ시오/EF ./SF
영겔르 가찹이 오나라.	영겔르/NNP 가찹이__1/NNG 이/VCP 오/EC 나라/NNG ./SF	여기로 가까이 오너라.	여기/NP 로/JKB 가까이/MAG 오/VV 너라/EF ./SF
배고푸무 부수깨서 다웅치 가졔가서 먹어라.	배고푸무/NNG 부수깨__1/NNG 서/NNG 다웅치__1/NNG 가졔/NNG 가/VV 어서/EC 먹/VV 어라/EF ./SF	배고프면 부엌에서 누룽지 가져가서 먹어라.	배고프/VA 면/EC 부엌/NNG 에서/JKB 누룽지/NNG 가져가/VV 어서/EC 먹/VV 어라/EF ./SF
아 들어서무 입스레미르 합지.	아__23/NNG 들/VV 어서/EC 무/XPN 입스레미__1/NNG 르/NNG 합/NNG 지/EF ./SF	아이가 들어서면 입덧을 하지요.	아이/NNG 가/JKS 들어서/VV 면/EC 입덧/NNG 을/JKO 하/VV 지요/EF ./SF
내 조꼼할 적에느 키 작앗습구마. 	나/NP 의/JKG 조꼼/NNG 하/VV ᆯ/ETM 적/NNB 에/JKB 느/NP 키/NNG 작앗습구마/NNG ./SF	내 조끄마할 적에는 키가 작았습니다.	나/NP 의/JKG 조끄마/NNG 하/VV ᆯ/ETM 적/NNB 에/JKB 는/JX 키/NNG 가/JKS 작/VA 었/EP 습니다/EF ./SF
상년 동삼에 옝기르 바람에 싹 날기구 고사아 했습지.	상년/NNG 동/MM 삼/NR 에/JKB 옝기__1/NNG 르/NNG 바람/NNG 에/JKB 싹/MAG 날기__1/VV 구/EC 고사아/NNG 하/XSV 었/EP 습지/NNG ./SF	상년 겨울에 이엉을 바람에 싹 날리고 고생을 했지요.	상년/NNG 겨울/NNG 에/JKB 이엉/NNG 을/JKO 바람/NNG 에/JKB 싹/MAG 날리/VV 고/EC 고생/NNG 을/JKO 하/VV 었/EP 지요/EF ./SF
내 아주바이느 젊어실 적에 고사아 많이 햇습구마. 	내/MM 아주바이__3/NNG 느/NP 젊/VA 어/EC 시/EP ᆯ/ETM 적/NNB 에/JKB 고사/NNG 아/NNG 많이/MAG 하/VV 엇/EP 습/NNG 구마/EF ./SF	내 형부는 젊었을 적에 고생을 많이 했습니다. 	나/NP 의/JKG 형부/NNG 는/JX 젊/VA 었/EP 을/ETM 적/NNB 에/JKB 고생/NNG 을/JKO 많이/MAG 하/VV 었/EP 습니다/EF ./SF
하불에미나 하불애비나 살기느 바쁩지. 	하불에미__1/NNG 나/JC 하불애비/NNG 나/JC 살기느/NNG 바쁩/NNG 이/VCP 지/EF ./SF	홀어미나 홀아비나 살기는 힘들지요. 	홀/NNG 어미/NNG 나/JC 홀아비/NNG 나/JC 살/VV 기/ETN 는/JX 힘들/VA 지요/EF ./SF
봄에 피는 꽂 중에서 하불에미고장으느 자디색이 납지.	봄/NNG 에/JKB 피/VV 는/ETM 꽂__1/NNG 중/NNB 에서/JKB 하불에미고장__1/NNG 으느/NNG 자디색__1/NNG 이/JKS 납/NNG 지/EF ./SF	봄에 피는 꽃 중에서 할미꽃은 자주색이 나지요.	봄/NNG 에/JKB 피/VV 는/ETM 꽃/NNG 중/NNB 에서/JKB 할미꽃/NNG 은/JX 자주색/NNG 이/JKS 나/VV 지요/EF ./SF
우리 클아반으느 오래 앉앗습구마.	우리/NP 클아반__1/NNG 으느/NNG 오래/MAG 앉/VV 엇/EF 습/NNG 구마/EF ./SF	우리 할아버지는 오래 사셨습니다.	우리/NP 할아버지/NNG 는/JX 오래/MAG 사/VV 시/EP 었/EP 습니다/EF ./SF
시금 아덜이사 우리 세는 멩실이 무시긴지 잘 모릅구마. 	시금__8/NNG 아__23/NNG 덜/XSN 이사/JX 우리/NP 세__21/VV 는/ETM 멩/NNG 실/NNG 이/JKS 무/XPN 시기/NNG 이/VCP ᆫ지/EC 잘/MAG 모릅구마/NNG ./SF	지금 아이들이야 우리가 쇠는 명절이 무엇인지 잘 모릅니다. 	지금/MAG 아이/NNG 들/XSN 이야/JX 우리/NP 가/JKS 쇠/VV 는/ETM 명절/NNG 이/JKS 무엇/NP 이/VCP ᆫ지/EC 잘/MAG 모르/VV ᆸ니다/EF ./SF
식귀 여서히 살무 시끄럽어서 내느 아니 둏아합구마. 	식/NNG 귀/NNG 여서히__1/NNG 살/NNB 무/XPN 시끄럽/VA-I 어서/EC 내느/NNG 아니/IC 둏__1/VA 어/EC 합/NNG 구마/EF ./SF	식구가 여럿이 살면 시끄러워서 나는 안 좋아합니다.	식구/NNG 가/JKS 여럿/NNG 이/JKS 살/VV 면/EC 시끄럽/VA-I 어서/EC 나/NP 는/JX 안/MAG 좋아하/VV ᆸ니다/EF ./SF
그 짓 녕감가 노친 모두 일없습더구마.	그/MM 짓/NNB 녕감__1/NNG 가/VV 노친/NNG 모두/MAG 일/NNG 없/VA 습/NNG 더/MAG 구마/EF ./SF	그 집 영감님과 노친 모두 괜찮으셨습니다.	그/MM 집/NNG 영감/NNG 님/XSN 과/JC 노친/NNG 모두/MAG 괜찮/VA 으시/EP 었/EP 습니다/EF ./SF
시방으느 기름우 얻자구 해자부리두 많이 싱구오.	시방으느/NNG 기름/NNG 우/NNG 얻/VV-R 자구/EC 해자부리__1/NNG 두/JX 많이/MAG 싱구__1/VV 오/EF ./SF	시방은 기름을 얻자고 해바라기도 많이 심으오.	시방/NNG 은/JX 기름/NNG 을/JKO 얻/VV-R 자고/EC 해바라기/NNG 도/JX 많이/MAG 심으오/NNG ./SF
붕혜가 저약에느 어디메 있니?	붕혜__1/NNG 가/JKS 저약__1/NNG 에/JKB 느/NP 어디메__1/NP 있/VV 니/EC ?/SF	부엉이가 저녁에는 어디 있니?	부엉이/NNG 가/JKS 저녁/NNG 에/JKB 는/JX 어디/NP 있/VV 니/EC ?/SF
사름덜 다치니까데 뎡게 웅데이르 잘 메꿔라.	사름__2/NNG 덜/XSN 다치/VV 니까/EC 데/NNB 뎡게__1/NP 웅데이__3/NNG 르/NNG 잘/MAG 메꾸/VV 어라/EF ./SF	사람들이 다치니까 저기 웅덩이를 잘 메워라.	사람/NNG 들/XSN 이/JKS 다치/VV 니까/EC 저기/NP 웅덩이/NNG 를/JKO 잘/MAG 메우/VV 어라/EF ./SF
그 무티를 가제와 놔라.	그/MM 무티__1/NNG 를/JKO 가제/NNG 와/JC 놓/VX 어라/EF ./SF	그 나무를 가져와 놓아라.	그/MM 나무/NNG 를/JKO 가져오/VV 어/EC 놓/VX 어라/EF ./SF
정재시리서 가재미 굽어 먹었슴메.	정재시리__1/NNG 서/JKB 가/VV 재미/NNG 굽/VA-R 어/EC 먹었슴메/NNG ./SF	정주에서 가자미 구워 먹었소.	정주/NNP 에서/JKB 가자미/NNG 굽/VV-I 어/EC 먹/VV 었/EP 소/EC ./SF
아가 오마니 우티 끝자라기르 잡구 있습메.	아__23/NNG 가/JKS 오마/NNP 이/VCP 니/EC 우티__1/NNG 끝자라기__1/NNG 르/NNG 잡/VV-R 구/EC 있/VX 습/NNG 메/NNG ./SF	아이가 어머니 옷 끝자락을 잡고 있네.	아이/NNG 가/JKS 어머니/NNG 옷/NNG 끝/NNG 자락/NNG 을/JKO 잡/VV-R 고/EC 있/VX 네/EF ./SF
네 함벌로 말으 하무 내 가만히 아이 잇갯다.	네/IC 함벌로__1/MAG 말/NNG 으/JKG 하/IC 무/NNG 내/NNB 가만히/MAG 아이/NNG 잇/NNG 개/VV 엇/EP 다/EF ./SF	네가 함부로 말을 하면 내가 가만히 있지 않겠다.	너/NP 가/JKS 함부로/MAG 말/NNG 을/JKO 하/VV 면/EC 나/NP 가/JKS 가만히/MAG 있/VV 지/EC 않/VX 겠/EP 다/EF ./SF
바쁘기 빳빳이 살구 기래다 나니 이래 나아 먹엇습구마. 	바쁘/VA 기/ETN 빳빳이__6/MAG 살/VV 구/EC 기래다/NNG 나/VV 니/EC 이렇/VA-I 어/EC 낫/VV-I 어/EC 먹/VV 엇/EP 습/NNG 구마/EF ./SF	힘들게 빠듯이 살고 그러나 보니 이리 나이를 먹었습니다. 	힘들/VA 게/EC 빠듯/XR 이/XSM 살/VV 고/EC 그러/VV 나/EC 보/VX 니/EC 이리/MAG 나이/NNG 를/JKO 먹/VV 었/EP 습니다/EF ./SF
허더칸에 쟁기구 무슨 냉기구 다 딜에놓소.	허더칸__1/NNG 에/JKB 쟁기/NNG 구/NNG 무슨/MM 냉기__2/NNG 구/NNG 이/VCP 다/EF 딜/NNG 에/JKB 놓/VV 소/EC ./SF	헛간에 농기구고 무슨 나무고 다 들여놓소.	헛간/NNG 에/JKB 농기구/NNG 이/VCP 고/EC 무슨/MM 나무/NNG 이/VCP 고/EC 다/MAG 들여놓/VV 소/EC ./SF
내 새끼소꾸락이 요즘 아풉구마.	나/NP 의/JKG 새끼소꾸락__1/NNG 이/JKS 요즘/NNG 아풉구마/NNG ./SF	내 새끼손가락이 요즘 아픕니다.	나/NP 의/JKG 새끼손가락/NNG 이/JKS 요즘/NNG 아프/VA ᆸ니다/EF ./SF
우리 어마니 애끼 남편이무 아즈바니라 하오.	우리/NP 어마/NNG 이/VCP 니/EC 애끼__1/NNG 남편/NNG 이/JKS 무/XPN 아즈바니__3/NNG 이/VCP 라/EC 하/VV 오/EF ./SF	우리 어머니 아우의 남편이면 이모부라 하오.	우리/NP 어머니/NNG 아우/NNG 의/JKG 남편/NNG 이/VCP 면/EC 이모부/NNG 이/VCP 라/EC 하/VV 오/EF ./SF
뽕여르매 열겟으무 따 오나라.	뽕여르매__1/NNG 열겟으무/NNG 따/VV 어/EC 오/VX 나라/NNG ./SF	오디가 열렸으면 따 오너라.	오디/NNP 가/JKS 열리/VV 었/EP 으면/EC 따/VV 어/EC 오/VV 너라/EF ./SF
꼬부대기 심바람으 갓다 온나라.	꼬부대기__1/MAG 심바람__1/NNG 으/NNG 가/VV 엇/EP 다/EC 오/VV ᆫ/ETM 나라/NNG ./SF	부지런히 심부름을 갔다 오너라.	부지런히/MAG 심부름/NNG 을/JKO 가/VV 었/EP 다/EC 오/VV 너라/EF ./SF
마른 검블으 모아셔 불으 지펬다.	마르/VV ᆫ/ETM 검블__1/NNG 으/NNG 모으/VV 어/EC 시/VA 어/EC 불/NNG 으/JKG 지펬/NNG 하/XSA 다/EF ./SF	마른 검불을 모아서 불을 지폈다.	마르/VV ᆫ/ETM 검불/NNG 을/JKO 모으/VV 어서/EC 불/NNG 을/JKO 지피/VV 었/EP 다/EF ./SF
자식덜이 다 서방가구 시집가구 기래구 안까니두 상새 나서 없구 집에 내 하분자 잇으니 늘상 헝둥하오.	$$$ 자식/NNG 덜/XSN 이/JKS 다/MAG 서방/NNG 가구/NNG 시집/NNG 가구/NNG 기래구/NNG 안/MAG 깔/VV 니/EC 두/MM 상/NNG 새/NNG 나/VV 어서/EC 없/VA 구/EC 집/NNG 에/JKB 나/NP 의/JKG 하/NNG 분자/NNG 잇/NNG 으니/EC 늘상/MAG 헝둥/NNG 하/XSA 오/EF ./SF	자식들이 다 장가가고 시집가고 그리고 부인도 죽어서 없고 집에 내가 혼자 있으니 늘상 허전하오.
그른 말 아이 씀다.	그른__1/MM 말/NNG 아이__12/MAG 쓰/VV ᆷ다/EF ./SF	그런 말 아니 씁니다.	그런/MM 말/NNG 아니/MAG 쓰/VV ᆸ니다/EF ./SF
네 어드메르 가나?	네/IC 어드메르/NNP 가/VV 나/EF ?/SF	너 어디를 가니?	너/NP 어디/NP 를/JKO 가/VV 니/EF ?/SF
장에 가서 염쉐르 싸 오너라.	장/NNG 에/JKB 가/VV 어서/EC 염쉐__1/NNG 르/NNG 싸__21/VV 오/VV 너라/EF ./SF	장에 가서 염소를 사 오너라.	장/NNG 에/JKB 가/VV 어서/EC 염소/NNG 를/JKO 사/VV 어/EC 오/VV 너라/EF ./SF
어레실 적 일으 해상하무 즐겁습구마. 	어레/NNG 이/VCP 시/EP ᆯ/ETM 적/NNB 일/NNG 으/NNG 해상하__2/VV 무/NNG 즐겁/VA-I 습/NNG 구마/EF ./SF	어렸을 적 일을 회상하면 즐겁습니다.	어리/VA 었/EP 을/ETM 적/NNB 일/NNG 을/JKO 회상/NNG 하/XSV 면/EC 즐겁/VA-I 습니다/EF ./SF
아덜으느 소압을 줏으러 산지슭을르 갔다.	아__23/NNG 덜/XSN 으/JKG 느/NP 소압__1/NNG 을/NNG 줏/VV-R 으러/EC 산지슭__1/NNG 을/JKO 르/NNG 가/VV 었/EP 다/EF ./SF	아이들은 솔가지를 주우러 산기슭으로 갔다.	아이/NNG 들/XSN 은/JX 솔가지/NNG 를/JKO 줍/VV-I 으러/EC 산기슭/NNG 으로/JKB 가/VV 었/EP 다/EF ./SF
영게 옥시두 많이 있습구마.	영게__1/NP 옥시__1/NNG 두/JX 많이/MAG 있/VA 습/NNG 구마/EF ./SF	여기 옥수수도 많이 있습니다.	여기/NP 옥수수/NNG 도/JX 많이/MAG 있/VA 습니다/EF ./SF
영게서 새채할 생각 말구 얼른 재비 집으르 가서 눕어 자오.	영게__1/NP 서/JKB 새채/NNG 하/XSV ᆯ/ETM 생각/NNG 말/VV 구/EC 얼른/MAG 재비/NNG 집으르/NNG 가/VV 어서/EC 눕/VV-I 어/EC 자/VV 오/EF ./SF	여기서 유숙할 생각 말고 얼른 자기 집으로 가서 누워 자오.	여기/NP 서/JKB 유숙/NNG 하/XSV ᆯ/ETM 생각/NNG 말/VV 고/EC 얼른/MAG 자기/NP 집/NNG 으로/JKB 가/VV 어서/EC 눕/VV-I 어/EC 자/VV 오/EF ./SF
그 담엔 제 쌀이 나오게끔 돼구 게 나간 건 나백게 나간단 말이오.	그/MM 담/NNG 에/JKB ᆫ/JX 저/NP 의/JKG 쌀/NNG 이/JKS 나오/VV 게끔/EC 돼__1/VV 구/EC 게__6/NNG 나가/VV ᆫ/ETM 거/NNB ᆫ/JX 나백게__1/NNG 나가/VV ᆫ단/ETM 말/NNG 이/VCP 오/EF ./SF	그 다음엔 제 쌀이 나오게끔 되고 겨가 나간 것은 쌀겨가 나간단 말이오.	그/MM 다음/NNG 에/JKB ᆫ/JX 저/NP 의/JKG 쌀/NNG 이/JKS 나오/VV 게끔/EC 되/VV 고/EC 겨/NNG 가/JKS 나가/VV ᆫ/ETM 것/NNB 은/JX 쌀겨/NNG 가/JKS 나가/VV ᆫ단/ETM 말/NNG 이/VCP 오/EF ./SF
가매뜨베르 생질르 잘 닦아라.	가매뜨베__1/NNG 르/NNG 생/NNG 질/XSN 르/NNG 잘/MAG 닦/VV 어라/EF ./SF	솥뚜껑을 행주로 잘 닦아라.	솥뚜껑/NNG 을/JKO 행주/NNG 로/JKB 잘/MAG 닦/VV 어라/EF ./SF
솔냉기처리 상낭구두 오래 사는 냉기입구마.	솔냉기__1/NNG 처리/NNG 상낭구__1/NNG 두/JX 오래/MAG 사/VV 는/ETM 냉기__2/NNG 입구/NNG 마/NNG ./SF	소나무처럼 향나무도 오래 사는 나무입니다.	소나무/NNG 처럼/JKB 향나무/NNG 도/JX 오래/MAG 사/VV 는/ETM 나무/NNG 이/VCP ᆸ니다/EF ./SF
도독 한 놈은 경찰덜게 붙들기우구 둘은 달아낫습구마.	도독__12/NNG 한/MM 놈/NNB 은/JX 경찰/NNG 덜/MAG 하/XSA 게/EC 붙들기우__1/VV 구/EC 둘/NR 은/JX 달아나/VV 엇/EP 습/NNG 구마/EF ./SF	도둑 한 놈은 경찰들에게 붙들리고 둘은 달아났습니다.	도둑/NNG 한/MM 놈/NNB 은/JX 경찰/NNG 들/XSN 에게/JKB 붙들리/VV 고/EC 둘/NR 은/JX 달아나/VV 었/EP 습니다/EF ./SF
모딘 낭기 많다 나니 땔낭그 걱정이사 없엇습구마.	모디/NNP ᆫ/JX 낭기__1/NNG 많/VA 다/EC 나/VX 니/EC 땔낭그__1/NNG 걱정/NNG 이사/JX 없/VA 엇/EP 습/NNG 구마/EF ./SF	굵은 나무가 많다 보니 땔나무 걱정이야 없었습니다.	굵/VA 은/ETM 나무/NNG 가/JKS 많/VA 다/EC 보/VX 니/EC 땔나무/NNG 걱정/NNG 이야/JX 없/VA 었/EP 습니다/EF ./SF
사등이에 뻬가 탁 부러뎃단 말이오.	사등이__1/NNG 에/JKB 뻬/NNG 가/JKS 탁/MAG 부러/MAG 데/VV 엇/EP 단/ETM 말/NNG 이/VCP 오/EF ./SF	등에 뼈가 탁 부러졌다는 말이오.	등/NNG 에/JKB 뼈/NNG 가/JKS 탁/MAG 부러지/VV 었/EP 다는/ETM 말/NNG 이/VCP 오/EF ./SF
세때기에 쓸이 돋으무 통세 나서 임셕으 먹지 못하오. 	세때기__1/NNG 에/JKB 쓰/VV ᆯ/ETM 이/MM 돋으무/NNG 통/NNG 세/MM 나/VX 어서/EC 임셕으/NNG 먹/VV 지/EC 못하/VX 오/EF ./SF	혀때기에 혓바늘이 돋으면 통세가 있어서 음식을 먹지 못하오. 	혀때기/NNG 에/JKB 혓바늘/NNG 이/JKS 돋/VV-R 으면/EC 통/MAG 세/NNG 가/JKS 있/VV 어서/EC 음식/NNG 을/JKO 먹/VV 지/EC 못하/VX 오/EF ./SF
야 웨컬아배 올해 야든이 넘었는데 정정합메다.	야/IC 웨컬아배__1/NNG 올해/NNG 야/IC 이/VCP 든/EC 이/NR 넘/VV 었/EP 는데/EC 정정/NNG 합/NNG 메/VV 다/EF ./SF	얘 외할아버지 올해 여든이 넘었는데 정정합니다.	얘/NP 외할아버지/NNG 올해/NNG 여든/NR 이/JKS 넘/VV 었/EP 는데/EC 정정/XR 하/XSA ᆸ니다/EF ./SF
내기 심심하다 나이 자주루 하페미르 합지.	내기/NNG 심심/XR 하/XSA 다/EC 나이/NNG 자주/MAG 루/NNG 하페미__1/NNG 르/NNG 합/NNG 지/EF ./SF	얘기가 심심하다 보니 자주 하품을 하지요.	얘기/NNG 가/JKS 심심/XR 하/XSA 다/EC 보/VX 니/EC 자주/MAG 하품/NNG 을/JKO 하/VV 지요/EF ./SF
우리 동네에 입따개 한내 잇는데 마음이 곱은 사름입구마.	우리/NP 동네/NNG 에/JKB 입따개__1/NNG 한내__2/NR 잇/VV-I 는데/EC 마음/NNG 이/JKS 곱/VA-I 은/ETM 사르/VV ᆷ/ETN 입/NNG 구마/EF ./SF	우리 동네에 언청이 하나가 있는데 마음이 고운 사랍입니다.	우리/NP 동네/NNG 에/JKB 언청이/NNG 하나/NR 가/JKS 있/VV 는데/EC 마음/NNG 이/JKS 곱/VA-I 은/ETM 사랍/NNG 이/VCP ᆸ니다/EF ./SF
어마네, 왜큰아매 오셋습구마.	어/IC 말/VV 네/EC ,/SP 왜/MAG 크/VA ᆫ/ETM 아매/MAG 오셋습구마/NNG ./SF	어머니, 외할머니 오셨습니다.	어머니/NNG ,/SP 외할머니/NNG 오/VV 시/EP 었/EP 습니다/EF ./SF
밖이 칩운데 팔뱅애 입구 나가라.	밖/NNG 이/MM 칩/NNG 우/NNG 이/VCP ᆫ데/EC 팔뱅애__1/NNG 입/VV-R 구/EC 나가/VV 라/EF ./SF	밖이 추운데 마고자 입고 나가라.	밖/NNG 이/JKS 춥/VA-I 은데/EC 마고자/NNG 입/VV-R 고/EC 나가/VV 라/EF ./SF
제 이림이 무스검둥?	저/NP 의/JKG 이림__1/NNG 이/JKS 무스__1/NNG 검/NNG 둥/MAG ?/SF	당신 이름이 무엇입니까?	당신/NP 이름/NNG 이/JKS 무엇/NP 이/VCP ᆸ니까/EF ?/SF
노인덜이 하는 니애기느 다 넷말이라구 아덜이 웃는단 말이오.	노인/NNG 덜/XSN 이/JKS 하/VV 는/ETM 니애기느/NNG 다/MAG 넷말__1/NNG 이/VCP 라구/EC 아__23/NNG 덜/XSN 이/JKS 웃/VV-R 는단/ETM 말/NNG 이/VCP 오/EF ./SF	노인들이 하는 얘기는 다 옛말이라고 아이들이 웃는단 말이오.	노인/NNG 들/XSN 이/JKS 하/VV 는/ETM 얘기/NNG 는/JX 다/MAG 옛말/NNG 이/VCP 라고/EC 아이/NNG 들/XSN 이/JKS 웃/VV-R 는단/ETM 말/NNG 이/VCP 오/EF ./SF
물으 길어 와서 항사례 물으 까뜩 채와라.	물/NNG 으/JKG 긷/VV-I 어/EC 오/VX 어서/EC 항/NNG 사례/NNG 물/NNG 으/JKG 까뜩/NNG 채/MAG 오/VV 어라/EF ./SF	물을 길어 와서 항아리에 물을 가뜩 채워라.	물/NNG 을/JKO 긷/VV-I 어/EC 오/VX 어서/EC 항아리/NNG 에/JKB 물/NNG 을/JKO 가뜩/MAG 채우/VV 어라/EF ./SF
갸느 핵교서두 글으 이르구 집에서두 글으 이르구 정말 기찹구마.	$$$ 갸느/NNG 핵교/NNG 서두/NNG 글/NNG 으/JKG 이르/VV-R 구/EC 집/NNG 에서/JKB 두/JX 글/NNG 으/JKG 이르/VV-R 구/EC 정말/MAG 기찹구마/NNG ./SF	그 아이는 학교에서도 공부를 하고 집에서도 공부를 하고 정말 기찹니다.
남물 담글 때 말임까?	남물__2/NNG 담그/VV ᆯ/ETM 때/NNG 말/NNG 이/VCP ᆷ/EC 까/VV 어/EF ?/SF	김치 담글 때 말입니까?	김치/NNG 담그/VV ᆯ/ETM 때/NNG 말/NNG 이/VCP ᆸ니까/EF ?/SF
메사기르 꿉어서 부르쌈에다가 싸 먹으문 좋지비.	메사기__1/NNG 르/NNG 꿉어서/NNG 부르/VV 쌈/NNG 에다가/JKB 싸/VV 어/EC 먹/VV 으문/EC 좋/VA 지/EF 비/NNG ./SF	메기를 구워서 상추쌈에다 싸 먹으면 좋지.	메기/NNP 를/JKO 굽/VV-I 어서/EC 상추/NNG 쌈/NNG 에다/JKB 싸/VV 어/EC 먹/VV 으면/EC 좋/VA 지/EF ./SF
잰내비르 본내는 사름두 잇습구마. 	잰내비__1/NNG 르/NNG 본내__1/VV 는/ETM 사름__2/NNG 두/JX 잇/VV-I 습/NNG 구마/EF ./SF	원숭이를 흉내질하는 사람도 있습니다. 	원숭이/NNG 를/JKO 흉내/NNG 질/XSN 하/XSV 는/ETM 사람/NNG 도/JX 있/VV 습니다/EF ./SF
정게 사는 하불아비르 내 이따가 보자구 하는데, 내가 같이 가갯소? 	정게__2/NP 사/VV 는/ETM 하불아비__1/NNG 르/NNG 내/NNB 이따/MAG 가/VV 어/EC 보/VX 자구/EC 하/VV 는데/EC ,/SP 나/NP 가/JKS 같이/MAG 가/VV 어/EC 개/VV 엇/EP 소/EC ?/SF	저기 사는 홀아비를 내가 이따가 보려고 하는데, 나와 같이 가겠소? 	저기/NP 사/VV 는/ETM 홀아비/NNG 를/JKO 나/NP 가/JKS 이따가/MAG 보/VV 려고/EC 하/VX 는데/EC ,/SP 나/NP 와/JKB 같이/MAG 가/VV 겠/EP 소/EC ?/SF
일하는 게 서거푸대닣구 일으 일씨 합구마. 	$$$ 일/NNG 하/XSV 는/ETM 것/NNB 이/JKS 서거푸대닣/NNG 구/NR 일/NNB 으/JKG 일/NR 씨/NNB 합/NNG 구마/EF ./SF	일하는 게 서투르지 않고 일을 제법 합니다. 
오놀 간거리는 무꾸다.	오노/NNP ᆯ/JKO 간거리__2/NNG 는/JX 무꾸/NNP 이/VCP 다/EF ./SF	오늘 반찬거리는 무다.	오늘/MAG 반찬거리/NNG 는/JX 무/NNG 이/VCP 다/EF ./SF
잇검에 가시 끼웟으니 가시르 뽑아야 하오.	잇검__1/NNG 에/JKB 가시/NNG 끼우/VV 엇/EP 으니/EC 가시/NNG 르/NNG 뽑/VV-R 어야/EC 하/VX 오/EF ./SF	잇몸에 가시가 끼었으니 가시를 뽑아야 하오.	잇몸/NNG 에/JKB 가시/NNG 가/JKS 끼/VV 었/EP 으니/EC 가시/NNG 를/JKO 뽑/VV-R 어야/EC 하/VX 오/EF ./SF
어제 숨우 쉬는데 불세르 허피 아팟습지.	어제/NNG 숨/NNG 우/NNG 쉬/VV 는데/EC 불세르/NNG 허피__1/NNG 아프/VA 엇/EP 습지/NNG ./SF	어제 숨을 쉬는데 갑자기 허파가 아팠지요.	어제/MAG 숨/NNG 을/JKO 쉬/VV 는데/EC 갑자기/MAG 허파/NNG 가/JKS 아프/VA 었/EP 지요/EF ./SF
저냑에는 불그르 싸 먹었습구마.	저냑__1/NNG 에/JKB 는/JX 불그__1/NNG 르/NNG 싸/VV 어/EC 먹/VV 었/EP 습/NNG 구마/EF ./SF	저녁에는 상추를 싸 먹었습니다.	저녁/NNG 에/JKB 는/JX 상추/NNG 를/JKO 싸/VV 어/EC 먹/VV 었/EP 습니다/EF ./SF
사양해서 잡은 산즘승의 서구레를 뻣긴다.	사양__1/NNG 하/XSV 어서/EC 잡/VV-R 은/ETM 산즘승/NNG 의/JKG 서구레__1/NNG 를/JKO 뻣__1/VV-R 기/ETN ᆫ/JX 하/VX 다/EF ./SF	사냥해서 잡은 산짐승의 가죽을 벗긴다.	사냥/NNG 하/XSV 어서/EC 잡/VV-R 은/ETM 산짐승/NNG 의/JKG 가죽/NNG 을/JKO 벗기/VV ᆫ다/EF ./SF
물외는 잘 싳어셔 겁지리르 뻿게셔 먹는다.	물/NNG 외/NNB 는/JX 잘/MAG 싳어셔/NNG 겁지리__1/NNG 르/NNG 뻿게셔/NNG 먹/VV 는다/EF ./SF	오이는 잘 씻어서 껍질을 벗겨서 먹는다.	오이/NNG 는/JX 잘/MAG 씻/VV-R 어서/EC 껍질/NNG 을/JKO 벗기/VV 어서/EC 먹/VV 는다/EF ./SF
갠으 가무 올채 많구 메구락지두 많습구마.	갠__1/NNG 으/JKG 가무/NNG 올채__1/NNG 많/VA 구/EC 메구락지__1/NNG 두/JX 많/VA 습/NNG 구마/EF ./SF	내를 가면 올챙이가 많고 개구리도 많습니다.	내/NNB 를/JKO 가/VV 면/EC 올챙이/NNG 가/JKS 많/VA 고/EC 개구리/NNG 도/JX 많/VA 습니다/EF ./SF
개지 머거리르 고내 앗아빼구 잇습구마. 	개지__3/NNG 머거리__5/NNG 르/NNG 고내__4/NNG 앗아빼__1/VV-R 구/EC 잇/NNG 습/NNG 구마/EF ./SF	강아지 먹이를 고양이가 빼앗고 있습니다. 	강아지/NNG 먹이/NNG 를/JKO 고양이/NNG 가/JKS 빼앗/VV-R 고/EC 있/VX 습니다/EF ./SF
사녕꾼이 몽노이가 차끼르 놓았다.	사녕/NNG 꾼/XSN 이/JKS 몽노이__1/NNG 가/JKS 차끼__1/NNG 르/NNG 놓/VV 었/EP 다/EF ./SF	사냥꾼이 올가미와 덫을 놓았다.	사냥/NNG 꾼/XSN 이/JKS 올가미/NNG 와/JC 덫/NNG 을/JKO 놓/VV 었/EP 다/EF ./SF
아들게 심바람 시길 때 헛눈팔지 말구 집으루 고도시 오라구 합지.	아들/NNG 게/EC 심바람__1/NNG 시/NNB 기/VV ᆯ/ETM 때/NNG 헛눈팔__1/VV 지/EC 말/VX 구/EC 집/NNG 으루/JKB 고도/NNP 시/NNG 오/VV 라구/EC 합/NNG 지/EF ./SF	아들에게 심부름 시킬 때 한눈팔지 말고 집으로 곧바로 오라고 하지요.	아들/NNG 에게/JKB 심부름/NNG 시키/VV ᆯ/ETM 때/NNG 한눈팔/VV 지/EC 말/VX 고/EC 집/NNG 으로/JKB 곧바로/MAG 오/VV 라고/EC 하/VV 지요/EF ./SF
입슌두 얍다샇구 나치두 곱아서 그 새애기 메누리 삼구 싶습구마.	입슌__1/NNG 두/MM 얍다샇구/NNG 나치두/NNG 곱/VA-I 어서/EC 그/MM 새/MM 애기/NNG 메누리/NNG 삼/VV 구/EC 싶/VX 습/NNG 구마/EF ./SF	입술도 얄따랗고 낯도 고와서 그 처녀를 며느리로 삼고 싶습니다.	입술/NNG 도/JX 얄따랗고/NNG 낯/NNG 도/JX 곱/VA-I 어서/EC 그/MM 처녀/NNG 를/JKO 며느리/NNG 로/JKB 삼/VV 고/EC 싶/VX 습니다/EF ./SF
그 집우 규수가 괜채잏더라.	그/MM 집/NNG 우/NNG 규수/NNG 가/JKS 괜채잏__1/VA 더라/EF ./SF	그 집의 규수가 괜찮더라.	그/MM 집/NNG 의/JKG 규수/NNG 가/JKS 괜찮/VA 더라/EF ./SF
붺에 가서 당쉬밥 좀 멕여 봐라.	붺__1/NNG 에/JKB 가/VV 어서/EC 당쉬밥__1/NNG 좀/MAG 멕이/VV 어/EC 보/VX 어라/EF ./SF	붴에 가서 눌은밥 좀 먹여 봐라.	붴/NNP 에/JKB 가/VV 어서/EC 눋/VV-I 은/ETM 밥/NNG 좀/MAG 먹이/VV 어/EC 보/VX 어라/EF ./SF
쬐곰하드문 돌에 걸게서 둘르 번제질 뻔햇소.	쬐곰하드문__1/MAG 돌/NNG 에/JKB 걸/VV 게/EC 서/VV 어/EC 두/VX ᆯ/ETM 르/NNG 번/NNB 제/XSN 질/XSN 뻔/NNB 하/XSA 엇/EP 소/EC ./SF	하마터면 돌에 걸려서 뒤로 넘어질 뻔했소.	하마터면/MAG 돌/NNG 에/JKB 걸리/VV 어서/EC 뒤/NNG 로/JKB 넘어지/VV ᆯ/ETM 뻔/NNB 하/XSA 었/EP 소/EC ./SF
동삼에 솜눈이 네리무 아덜이 바긑으르 나가 둏다구 놀구 그리합구마.	동/MM 삼/NR 에/JKB 솜눈__1/NNG 이/JKS 네리무/NNG 아__23/NNG 덜/XSN 이/JKS 바긑으르/NNG 나가/VV 어/EC 둏__1/VA 다구/EC 놀/VV 구/EC 그리/MAG 합/NNG 구마/EF ./SF	겨울에 함박눈이 내리면 아이들이 바깥으로 나가 좋다고 놀고 그리합니다.	겨울/NNG 에/JKB 함박눈/NNG 이/JKS 내리/VV 면/EC 아이/NNG 들/XSN 이/JKS 바깥/NNG 으로/JKB 나가/VV 어/EC 좋/VA 다고/EC 놀/VV 고/EC 그리/MAG 하/XSV ᆸ니다/EF ./SF
구차하게 살다가 이쎄 제구나 살 만합구마.	구차/NNG 하/XSA 게/EC 살/VV 다가/EC 이쎄__1/NNG 제구나__1/MAG 살/VV ᆯ/ETM 만/NR 합/NNG 구마/EF ./SF	구차하게 살다가 요사이 겨우 살 만합니다.	구차/NNG 하/XSA 게/EC 살/VV 다가/EC 요사이/NNG 겨우/MAG 살/VV ᆯ/ETM 만/NNB 하/XSA ᆸ니다/EF ./SF
이 문제느 풀기 바쁩구마.	이/MM 문제/NNG 느/NP 풀/VV 기/ETN 바쁩구마/NNG ./SF	이 문제는 풀기 어렵습니다.	이/MM 문제/NNG 는/JX 풀/VV 기/ETN 어렵/VA-I 습니다/EF ./SF
동삼에 강이 얼무 겅게서 강판쇄기르 하구 기랫습구마. 	동/MM 삼/NR 에/JKB 강/NNG 이/JKS 얼/VV ᆯ/ETM 무/NNG 겅게__1/NP 서/JKB 강판쇄기__1/NNG 르/NNG 하구/NNG 기랫습구마/NNG ./SF	동삼에 강이 얼면 거기서 얼음지치기를 하고 그랬습니다.	동/MM 삼/NR 에/JKB 강/NNG 이/JKS 얼/VV 면/EC 거기/NP 서/JKB 얼음/NNG 지치/VV 기/ETN 를/JKO 하/VV 고/EC 그렇/VA-I 었/EP 습니다/EF ./SF
아덜 멫으 더부리구 시장에 물건 사러 갓습구마. 	아__23/NNG 덜/XSN 멫으/NNG 더부리__1/VV 구/EC 시장/NNG 에/JKB 물건/NNG 사/VV 러/EC 가/VV 엇/EP 습/NNG 구마/EF ./SF	아이들 몇을 데리고 시장에 물건 사러 갔습니다. 	아이/NNG 들/XSN 몇/NR 을/JKO 데리/VV 고/EC 시장/NNG 에/JKB 물건/NNG 사/VV 러/EC 가/VV 었/EP 습니다/EF ./SF
이 강에느 짜작돌이 많소.	이/MM 강/NNG 에/JKB 느/NP 짜작돌__1/NNG 이/JKS 많/VA 소/EC ./SF	이 강에는 자갈이 많소.	이/MM 강/NNG 에/JKB 는/JX 자갈/NNG 이/JKS 많/VA 소/EC ./SF
내 안깐이 생전해 잇을 적에 제일 좋아햇던 꽂이 해갸부리엿습구마.	나/NP 의/JKG 안깐이__1/NNG 생전/NNG 하/VV 어/EC 잇/VX-R 을/ETM 적/NNB 에/JKB 제/XPN 일/NR 좋아하/VV 엇/EP 던/ETM 꽂__1/NNG 이/JKS 해갸부리__1/NNG 이/VV 엇/EP 습/NNG 구마/EF ./SF	내 아내가 생존해 있을 적에 제일 좋아했던 꽃이 해바라기였습니다.	나/NP 의/JKG 아내/NNG 가/JKS 생존/NNG 하/XSV 어/EC 있/VX 을/ETM 적/NNB 에/JKB 제/XPN 일/NR 좋아하/VV 었/EP 던/ETM 꽃/NNG 이/JKS 해바라기/NNG 이/VCP 었/EP 습니다/EF ./SF
파이나서 궁기 난 우티두 다 깁어서 입습구마. 	파이/VV 나/VX 어서/EC 궁기__3/NNG 나/VV ᆫ/ETM 우티__1/NNG 두/JX 다/MAG 깁/VV-I 어서/EC 입/VV-R 습/NNG 구마/EF ./SF	해져서 구멍이 난 옷도 다 기워서 입습니다. 	해/NNG 지/VV 어서/EC 구멍/NNG 이/JKS 나/VV ᆫ/ETM 옷/NNG 도/JX 다/MAG 깁/VV-I 어서/EC 입/VV-R 습니다/EF ./SF
정게 학교에 글으 니르러 가는 학재르 보니 아들이 생각납구마.	$$$ 정/MAG 게/EC 학교/NNG 에/JKB 글/NNG 으/JKG 니/NP 르/NNG 러/EC 가/VV 는/ETM 학재르/NNG 보/VV 니/EC 아들/NNG 이/JKS 생각/NNG 납/NNG 구마/EF ./SF	저기 학교에 공부하러 가는 학생을 보니 아들이 생각납니다.
우리 아부지느 이쎄 까딱하문 홰르 쓰읍구마.	우리/NP 아부지__2/NNG 느/NP 이쎄/NNG 까딱하문__1/MAG 홰르/NNG 쓰읍/IC 구마/EF ./SF	우리 아버지는 요즈음 까딱하면 화를 냅니다.	우리/NP 아버지/NNG 는/JX 요즈음/NNG 까딱하면/MAG 화/NNG 를/JKO 내/VV ᆸ니다/EF ./SF
눈멀댕이 혼재서 그 많은 일으 다 하란 말이오?	눈멀댕이__1/NNG 혼/NNG 재/VV 어서/EC 그/MM 많/VA 은/ETM 일/NNG 으/JKG 다/MAG 하/VV 란/ETM 말/NNG 이/VCP 오/EF ?/SF	맹인 혼자서 그 많은 일을 다 하란 말이오?	맹인/NNG 혼자/NNG 서/JKS 그/MM 많/VA 은/ETM 일/NNG 을/JKO 다/MAG 하/VV 란/ETM 말/NNG 이/VCP 오/EF ?/SF
나느 가슬이무 칩어서 하부옷을 애이 입습구마. 	나느/NNP 가슬__1/NNG 이/JKS 무/NNG 칩/NNG 어서/EC 하부옷__1/NNG 을/JKO 애/NNG 이/MM 입/VV-R 습/NNG 구마/EF ./SF	나는 가을이면 추워서 홑옷을 안 입습니다.	나/NP 는/JX 가을/NNG 이/VCP 면/EC 춥/VA-I 어서/EC 홑옷/NNG 을/JKO 안/MAG 입/VV-R 습니다/EF ./SF
한국에서두 나아 뉵십 먹으무 한갑사아 받소?	한국/NNP 에서/JKB 두/MM 낫/VV-I 어/EC 뉵십__1/NR 먹으무/NNG 한/MM 갑/NNG 사/VV 어/EC 받/VV-R 소/EC ?/SF	한국에서도 나이를 육십 먹으면 환갑상을 받소?	한국/NNP 에서/JKB 도/JX 나이/NNG 를/JKO 육십/NR 먹/VV 으면/EC 환갑/NNG 상/NNG 을/JKO 받/VV-R 소/EC ?/SF
그 집 이부어미 자식덜 잘 재래우다 나이 친어마니 가트짐.	$$$ 그/MM 집/NNG 이/NR 부/NNB 어미/NNG 자식/NNG 덜/XSN 잘/MAG 재래우다/NNG 나이/NNG 친어마니/NNG 가트짐/NNG ./SF	그 집 의붓어미가 자식들 잘 키우다 보니까 친어머니 같지 뭐.
뻐구새 눈으 보무 무섭소. 	뻐구새/NNG 눈/NNG 으/JKG 보무/NNG 무섭/VA-I 소/EC ./SF	뻐꾹새 눈을 보면 무섭소. 	뻐꾹새/NNG 눈/NNG 을/JKO 보/VV 면/EC 무섭/VA-I 소/EC ./SF
할럴으느 일없구 할럴으느 칩구 열이 나구 하는 그 벵으 고굼앓이라구 합지.	할럴__1/NNG 으느/NNG 일/NNG 없/VA 구/EC 할럴__1/NNG 으느/NNG 칩__1/VA-I 구/EC 열/NNG 이/JKS 나/VV 구/EC 하/VX 는/ETM 그/MM 벵__2/NNG 으/JKG 고굼앓이__1/NNG 라구/EC 합/NNG 지/EF ./SF	하루는 괜찮고 하루는 춥고 열이 나고 하는 그 병을 학질이라고 하지요.	하루/NNG 는/JX 괜찮/VA 고/EC 하루/NNG 는/JX 춥/VA-I 고/EC 열/NNG 이/JKS 나/VV 고/EC 하/VX 는/ETM 그/MM 병/NNG 을/JKO 학질/NNG 이/VCP 라고/EC 하/VV 지요/EF ./SF
고바에 가서 왜매재르 가제옵세.	고/MM 바/NNG 에/JKB 가/VV 어서/EC 왜매재__1/NNG 르/NNG 가제옵세/NNG ./SF	광에 가서 오미자를 가져오게.	광/NNG 에/JKB 가/VV 어서/EC 오미자/NNG 를/JKO 가져오/VV 게/EF ./SF
떡으 먹으무 자주루 떡이 하느바디에 붙습구마.	떡/NNG 으/JKG 먹/VV 으/EF 무/XPN 자주/NNG 루/JKB 떡/NNG 이/JKS 하느바디__1/NNG 에/JKB 붙/VV 습/NNG 구마/EF ./SF	떡을 먹으면 자주 떡이 입천장에 붙습니다.	떡/NNG 을/JKO 먹/VV 으면/EC 자주/MAG 떡/NNG 이/JKS 입천장/NNG 에/JKB 붙/VV 습니다/EF ./SF
훍이 좋으니까데 봄에 시문 무끼두 잘댓습구마. 	훍__1/NNG 이/JKS 좋/VA 으니까/EC 데/NNB 봄/NNG 에/JKB 시문/NNG 무끼__1/NNG 두/JX 잘/MAG 댓/NR 습/NNG 구마/EF ./SF	흙이 좋으니까 봄에 심은 무도 잘됐습니다. 	흙/NNG 이/JKS 좋/VA 으니까/EC 봄/NNG 에/JKB 심/VV 은/ETM 무/NNG 도/JX 잘/MAG 되/VV 었/EP 습니다/EF ./SF
우리 가시아바니래 종성에서 살았지.	우리/NP 가시아바니__1/NNG 래/NNG 종/NNG 성/NNG 에서/JKB 살/VV 었/EP 지/EF ./SF	우리 가시아버지가 종성에서 살았지.	우리/NP 가/JKS 시아버지/NNG 가/JKS 종성/NNP 에서/JKB 살/VV 었/EP 지/EF ./SF
밤에 산우 가무 버끼기 우는 소리 더 크기 듣깁구마. 	밤/NNG 에/JKB 산/NNG 우/NNG 가무/NNG 버끼기__1/NNG 울/VV 는/ETM 소리/NNG 더/MAG 크기/NNG 듣/VV-I 깁/VV-I 구마/EF ./SF	밤에 산을 가면 뻐꾸기 우는 소리가 더 크게 들립니다. 	밤/NNG 에/JKB 산/NNG 을/JKO 가/VV 면/EC 뻐꾸기/NNG 울/VV 는/ETM 소리/NNG 가/JKS 더/MAG 크/VA 게/EC 들리/VV ᆸ니다/EF ./SF
동미 내가 같이 낼래 집으르 가자구 합구마. 	동미__1/NNG 나/NP 가/JKS 같이/MAG 낼래__1/MAG 집으르/NNG 가/VV 자구/EC 합/NNG 구마/EF ./SF	동무가 나와 같이 빨리 집으로 가자고 합니다. 	동무/NNG 가/JKS 나/NP 와/JKB 같이/MAG 빨리/MAG 집/NNG 으로/JKB 가/VV 자고/EC 하/VV ᆸ니다/EF ./SF
이리 나사오나라.	이리/MAG 나사오__1/VV 나라/NNG ./SF	이리 나아오너라.	이리/MAG 낫/VV-I 어/EC 오/VV 너라/EF ./SF
사름덜 모두 다 펭등하게 잘사자구 헉명을 한 게지. 	사름__2/NNG 덜/XSN 모두/MAG 다/MAG 펭등/NNG 하/XSA 게/EC 잘/MAG 사/VV 자구/EC 헉명__1/NNG 을/JKO 하/VV ᆫ/ETM 것/NNB 이/VCP 지/EF ./SF	사람들 모두 다 평등하게 잘살자고 혁명을 한 것이지. 	사람/NNG 들/XSN 모두/MAG 다/MAG 평등/NNG 하/XSA 게/EC 잘/MAG 살/VV 자고/EC 혁명/NNG 을/JKO 하/VV ᆫ/ETM 것/NNB 이/VCP 지/EF ./SF
자토매기 가제가 씁소.	자토매기__1/NNG 가/JKS 저/NP 가/JKS 씁__1/VA 소/EF ./SF	자투리 가져가 쓰십시오.	자투리/NNG 가져가/VV 어/EC 쓰/VV 시/EP ᆸ시오/EF ./SF
환겁이 되무 크게 잔체르 합지. 	환겁__1/NNG 이/JKC 되/VV 무/XPN 크/VA 게/EC 잔체__2/NNG 르/NNG 합/NNG 지/EF ./SF	환갑이 되면 크게 잔치를 하지요.	환갑/NNG 이/JKC 되/VV 면/EC 크/VA 게/EC 잔치/NNG 를/JKO 하/VV 지요/EF ./SF
집 두에 있는 바재느 싸릴르두 맨들구 버들르두 맨드오.	집/NNG 두/MM 에/JKB 있/VV 는/ETM 바재__2/NNG 느/NP 싸릴르두/NNG 맨들/VV 구/EC 버들르두/NNG 맨들/VV 오/EF ./SF	집 뒤에 있는 울타리는 싸리로도 만들고 버들로도 만드오.	집/NNG 뒤/NNG 에/JKB 있/VV 는/ETM 울타리/NNG 는/JX 싸리/NNG 로/JKB 도/JX 만들/VV 고/EC 버들/NNG 로/JKB 도/JX 만들/VV 오/EF ./SF
죄기두 차구 골팽이도 치구 더 놀다 가지 애이쿠.	죄기두/NNG 차/VV 구/EC 골팽이__2/NNG 도/JX 치/VV 구/EC 더/MAG 놀/VV 다/EC 가/VV 지/EF 애이쿠/NNG ./SF	제기도 차고 팽이도 치고 더 놀다 가지 않고.	제/MM 기/NNG 도/JX 차/VV 고/EC 팽이/NNG 도/JX 치/VV 고/EC 더/MAG 놀/VV 다/EC 가/VV 지/EC 않/VX 고/EF ./SF
해 없어지는 거 해개라 합구마.	해/NNG 없/VA 어/EC 지/VX 는/ETM 거/NNB 해개__1/NNG 라/NNG 합/NNG 구마/EF ./SF	해가 없어지는 걸 일식이라 합니다.	해/NNG 가/JKS 없/VA 어/EC 지/VX 는/ETM 거/NNB ᆯ/JKO 일식/NNG 이/VCP 라/EC 하/VV ᆸ니다/EF ./SF
두 사름우 손구락이 갈싸한다.	두/MM 사름__2/NNG 우/JKG 손/NNG 구/NNG 락/NNG 이/JKS 갈싸/NNG 하/XSV ᆫ다/EF ./SF	두 사람의 손가락이 갈씬한다.	두/MM 사람/NNG 의/JKG 손가락/NNG 이/JKS 갈/NNP 씨/NNB ᆫ/JX 하/VV ᆫ다/EF ./SF
밤이 오무 버꿍기 우는 소리 자주루 듣겟습구마.	밤/NNG 이/JKS 오/VV 무/NNG 버꿍기/NNP 우/NNG 는/JX 소리/NNG 이/VCP 자/EC 주루/NNG 듣/VV-I 겟/EP 습/NNG 구마/EF ./SF	밤이 오면 뻐꾸기 우는 소리가 자주 들렸습니다.	밤/NNG 이/JKS 오/VV 면/EC 뻐꾸기/NNG 울/VV 는/ETM 소리/NNG 가/JKS 자주/MAG 들리/VV 었/EP 습니다/EF ./SF
내 영게서 난 사림이 아니다 나이까데 영게 사름덜이 어찌 살앗는두 내사 그거 옴판 모르오.	나/NP 의/JKG 영게__1/NP 서/JKB 나/NP ᆫ/JX 사림/NNG 이/JKC 아니/VCN 다/EF 나이까데/NNG 영게__1/NP 사름__2/NNG 덜/XSN 이/JKS 어찌/MAG 살/VV 앗/VV-R 는/ETM 두/MM 내사/NNG 그거/NP 옴판__1/MAG 모르/VV 오/EF ./SF	내가 여기에서 태어난 사람이 아니다 보니까 여기 사람들이 어찌 살았는지 나야 그걸 원래 모르오.	나/NP 가/JKS 여기/NP 에서/JKB 태어나/VV ᆫ/ETM 사람/NNG 이/JKC 아니/VCN 다/EC 보/VX 니까/EC 여기/NP 사람/NNG 들/XSN 이/JKS 어찌/MAG 살/VV 었/EP 는지/EC 나/NP 이/VCP 야/EF 그거/NP ᆯ/JKO 원래/MAG 모르/VV 오/EF ./SF
나 먹으무 절르 주룩사리 생깁지. 	나/NP 먹/VV 으/EF 무/XPN 절/NNG 르/NNG 주룩사리__1/NNG 생/XPN 깁/VV-I 지/EF ./SF	나이 먹으면 저절로 주름살이 생기지요. 	나이/NNG 먹/VV 으면/EC 저절로/MAG 주름살/NNG 이/JKS 생기/VV 지요/EF ./SF
꼴랑한 일에 마음 쓰디 말라우.	꼬/VV ᆯ랑/JX 하/VV ᆫ/ETM 일/NNG 에/JKB 마음/NNG 쓰/VV 디/EC 말/VX 라우/EF ./SF	하찮은 일에 마음 쓰지 마오.	하찮/VA 은/ETM 일/NNG 에/JKB 마음/NNG 쓰/VV 지/EC 말/VX 오/EF ./SF
동삼이 기나구 봄이 오무 기분이 둏습구마. 	동/MM 삼/NR 이/JKS 기나__1/VV 구/EC 봄/NNG 이/JKS 오/VV 무/XPN 기분/NNG 이/JKS 둏__1/VA 습/NNG 구마/EF ./SF	동삼이 지나고 봄이 오면 기분이 좋습니다.	동/MM 삼/NR 이/JKS 지나/VV 고/EC 봄/NNG 이/JKS 오/VV 면/EC 기분/NNG 이/JKS 좋/VA 습니다/EF ./SF
국화꽂을 집 안에 놓으니까데 좋은 행숫내 납구마.	국화/NNG 꽂/VV 을/ETM 집/NNG 안/NNG 에/JKB 놓/VV 으니까/EC 데/NNB 좋/VA 은/ETM 행숫내__1/NNG 납/NNG 구마/EF ./SF	국화꽃을 집 안에 놓으니까 좋은 향내가 납니다.	국화꽃/NNG 을/JKO 집/NNG 안/NNG 에/JKB 놓/VV 으니까/EC 좋/VA 은/ETM 향내/NNG 가/JKS 나/VV ᆸ니다/EF ./SF
호로래기르 불무 달음박질으 하구 그랫습지. 	호로래기__1/NNG 르/NNG 불무/NNG 달음박질/NNG 으/NNG 하/VV 구/EC 그렇/VA-I 엇/EP 습지/NNG ./SF	호루라기를 불면 달리기를 하고 그랬지요. 	호루라기/NNG 를/JKO 불/VV 면/EC 달리기/NNG 를/JKO 하/VV 고/EC 그렇/VA-I 었/EP 지요/EF ./SF
옛날에사 놀옴감이 많이 없다 나니 한데 나가서 아덜끼리 곰치울내기두 하구 기랫습지.	옛날/NNG 에/JKB 사/NR 놀옴감__1/NNG 이/VCP 많이/MAG 없/VA 다/EC 나/VX 니/EC 한/MM 데/NNB 나가/VV 어서/EC 아__23/NNG 덜/XSN 끼리/XSN 곰치울내기__1/NNG 두/JX 하/VV 구/EC 기랫습/NNG 이/VCP 지/EF ./SF	옛날에야 노리개가 많이 없다 보니 한데 나가서 아이들끼리 숨바꼭질도 하고 그랬지요.	옛날/NNG 에/JKB 야/JX 노리개/NNG 가/JKS 많이/MAG 없/VA 다/EC 보/VX 니/EC 한/MM 데/NNB 나가/VV 어서/EC 아이/NNG 들/XSN 끼리/XSN 숨바꼭질/NNG 도/JX 하/VV 고/EC 그렇/VA-I 었/EP 지요/EF ./SF
불쎄르 베락이 치무 회둥그랗게 눈을 뜹지. 	불쎄르__1/MAG 베락__2/NNG 이/JKS 치무/NNG 회둥그랗__1/VA 게/EC 눈/NNG 을/JKO 뜹/NNG 지/EF ./SF	갑자기 벼락이 치면 회동그랗게 눈을 뜨지요.	갑자기/MAG 벼락/NNG 이/JKS 치/VV 면/EC 회/NNG 동그랗/VA-I 게/EC 눈/NNG 을/JKO 뜨/VV 지요/EF ./SF
기푼 바당물에 사는 물고기 맛이 잇습구마.	기/NNG 풀/VV ᆫ/ETM 바당물__1/NNG 에/JKB 사/VV 는/ETM 물고기/NNG 맛/NNG 이/JKS 잇/VV-I 습/NNG 구마/EF ./SF	깊은 바닷물에 사는 물고기가 맛이 있습니다.	깊/VA 은/ETM 바닷물/NNG 에/JKB 사/VV 는/ETM 물고기/NNG 가/JKS 맛/NNG 이/JKS 있/VV 습니다/EF ./SF
자기 닙장두 세우지 아니하구 어찌 살갯슴둥?	자기/NP 닙장__1/NNG 두/JX 세우/VV 지/EC 아니하/VX 구/EC 어찌/MAG 살갯슴둥/NNG ?/SF	자기 입장도 세우지 않고 어찌 살겠습니까?	자기/NP 입장/NNG 도/JX 세우/VV 지/EC 않/VX 고/EC 어찌/MAG 살/VV 겠/EP 습니까/EF ?/SF
배고프이 얼신 집에 가서 밥으 먹구 오나라. 	배고프/VA 이/EC 얼신__2/MAG 집/NNG 에/JKB 가/VV 어서/EC 밥/NNG 으/JKG 먹/VV 구/EC 오나라/NNP ./SF	배고프니 얼른 집에 가서 밥을 먹고 오너라. 	배고프/VA 니/EC 얼른/MAG 집/NNG 에/JKB 가/VV 어서/EC 밥/NNG 을/JKO 먹/VV 고/EC 오/VV 너라/EF ./SF
물이 꼴똑차도록 붓어라.	물/NNG 이/JKS 꼴똑차__1/VA 도록/EC 붓/VV-I 어라/EF ./SF	물이 가득하도록 부어라.	물/NNG 이/JKS 가득/MAG 하/XSA 도록/EC 붓/VV-I 어라/EF ./SF
바쁜 일으느 사름덜이 다 슳에합구마. 	바쁘/VA ᆫ/ETM 일으느/NNG 사름__2/NNG 덜/XSN 이/JKS 다/MAG 슳__1/VA 에/JKB 합/NNG 구마/EF ./SF	어려운 일은 사람들이 다 싫어합니다. 	어렵/VA-I 은/ETM 일/NNG 은/JX 사람/NNG 들/XSN 이/JKS 다/MAG 싫어하/VV ᆸ니다/EF ./SF
어시 말으 듣댸니무 옛날에느 회리챌르 맞앗습구마. 	$$$ 어/IC 시/NNG 말/NNG 으/JKG 듣댸니무/NNG 옛날/NNG 에/JKB 느/NP 회리챌르/NNG 맞앗습구마/NNG ./SF	어버이 말을 듣지 않으면 옛날에는 회초리로 맞았습니다.
다른 데 가서 놀디 말구 곧기 집을르 가가라.	다른/MM 데/NNB 가/VV 어서/EC 놀/VV 디/EC 말/VX 구/EC 곧기__1/MAG 집/NNG 을/JKO 르/NNG 가/NNG 가/VV 어라/EF ./SF	다른 데 가서 놀지 말고 곧장 집으로 가거라.	다른/MM 데/NNB 가/VV 어서/EC 놀/VV 지/EC 말/VX 고/EC 곧장/MAG 집/NNG 으로/JKB 가/VV 거라/EF ./SF
나아 먹으니까더 이마떼계 쭈룩살이 늘어나오.	낫/VV-I 어/EC 먹/VV 으니까/EC 더/MAG 이마떼계/NNG 쭈룩살__1/NNG 이/JKS 늘어나/VV 오/EF ./SF	나이 먹으니까 이마빼기에 주름살이 늘어나오.	나이/NNG 먹/VV 으니까/EC 이마/NNG 빼/VV 기에/EC 주름살/NNG 이/JKS 늘어나/VV 오/EF ./SF
홀루 사는 것두 둏다구 하는 사름두 잇답더구마. 	$$$ 홀/NNG 루/JKB 사/VV 는/ETM 것/NNB 두/JX 둏/NNG 이/VCP 다구/EC 하/VV 는/ETM 사름두/NNG 잇/NNG 답/XSA-I 더/EP 구마/EF ./SF	홀로 사는 것도 좋다고 하는 사람도 있다고 합니다. 
기슴매자구 하무 반드시 홈미 잇어야 합지. 	기슴매__1/VV 자구/EC 하/VV 무/XPN 반드시/MAG 홈미__1/NNG 잇/VX-R 어야/EC 합/NNG 지/EF ./SF	김매자고 하면 반드시 호미가 있어야 하지요. 	김매/VV 자고/EC 하/VV 면/EC 반드시/MAG 호미/NNG 가/JKS 있/VV 어야/EC 하/VX 지요/EF ./SF
아들이 해잘싸해서리 내가 혼냈습문다.	아__23/NNG 들/XSN 이/JKS 해잘싸해서리/NNG 나/NP 가/JKS 혼내/VV 었/EP 습/NNG 물/VV ᆫ다/EF ./SF	아이들이 방정맞아서 내가 혼냈습니다.	아이/NNG 들/XSN 이/JKS 방정맞/VA 어서/EC 나/NP 가/JKS 혼내/VV 었/EP 습니다/EF ./SF
사름덜으느 헗은 일으 더 둏아합구마.	사름__2/NNG 덜/XSN 으/JKG 느/NP 헗/NNG 은/JX 일/NR 으/NNG 더/MAG 둏__1/VA 어/EC 합/NNG 구마/EF ./SF	사람들은 쉬운 일을 더 좋아합니다.	사람/NNG 들/XSN 은/JX 쉽/VA-I 은/ETM 일/NNG 을/JKO 더/MAG 좋아하/VV ᆸ니다/EF ./SF
함벌루 주멍이르 대배지 말라우.	함벌루__1/MAG 주/VV 멍/NNG 이/JKS 르/NNG 대/NNB 배/VV 지/EC 말/VX 라우/EF ./SF	함부로 주머니를 뒤지지 마시오.	함부로/MAG 주머니/NNG 를/JKO 뒤지/VV 지/EC 말/VX 시/EP 오/EF ./SF
하룻동이 우에 적쇄 놓구 물고기두 굽구 그랫습지. 	하룻동이__1/NNG 우에/MAG 적쇄/NNG 놓/VV 구/EC 물고기/NNG 두/JX 굽/VV-I 구/EC 그렇/VA-I 엇/EP 습지/NNG ./SF	화로 위에 석쇠 놓고 물고기도 굽고 그랬지요.	화로/NNG 위/NNG 에/JKB 석쇠/NNG 놓/VV 고/EC 물고기/NNG 도/JX 굽/VV-I 고/EC 그렇/VA-I 었/EP 지요/EF ./SF
여부락바티두 나무새 무세 잘 자랍구마.	여부락바티__1/NNG 두/MM 나무새__3/NNG 무세__2/MAG 잘/MAG 자랍구마/NNG ./SF	비탈밭도 남새가 몹시 잘 자랍니다.	비탈밭/NNG 도/JX 남/NNG 새/NNG 가/JKS 몹시/MAG 잘/MAG 자라/VV ᆸ니다/EF ./SF
옛날에사 많앳어두 즈끔우느 해부래기 많재냇습지.	$$$ 옛날/NNG 에/JKB 사/NR 많앳어두/NNP 즈끔우느/NNP 해부래기/NNP 많재냇/NNP 습지/NNG ./SF	옛날에야 많았어도 지금은 해오라기가 많지 않지요.
말자갈 쇠땔르 맨든 게 애이디?	말자갈__1/NNG 쇠땔르/NNG 맨들/VV ᆫ/ETM 것/NNB 이/JKS 애이__1/VA 디/EC ?/SF	재갈이 쇠로 만든 게 아니지?	재갈/NNG 이/JKS 쇠/NNG 로/JKB 만들/VV ᆫ/ETM 것/NNB 이/JKC 아니/VCN 지/EF ?/SF
넷날에느 이 가름다시 귀햇습구마.	넷날에느/NNP 이/JKS 가름다시__1/NNG 귀하/VA 엇/EP 습/NNG 구마/EF ./SF	옛날에는 이 성냥이 귀했습니다.	옛날/NNG 에/JKB 는/JX 이/MM 성냥/NNG 이/JKS 귀하/VA 었/EP 습니다/EF ./SF
사림이 지내 모딜무 동미 없습구마. 	사림/NNG 이/JKS 지내/VV 어/EC 모딜__4/VA 무/XPN 동미__1/NNG 없/VA 습/NNG 구마/EF ./SF	사람이 너무 모질면 동무가 없습니다. 	사람/NNG 이/JKS 너무/MAG 모질/VA 면/EC 동무/NNG 가/JKS 없/VA 습니다/EF ./SF
모래기가 뻘겋지 애임둥?	모래기__4/NNG 가/JKS 뻘겋/VA-I 지/EC 애/NNG 이/VCP ᆷ/EF 둥/NNB ?/SF	말갈기가 빨갛지 않습니까?	말/NNG 갈기/NNG 가/JKS 빨갛/VA-I 지/EC 않/VX 습니까/EF ?/SF
보롬날이 기나무 년으 날구디 아니하오.	보로/NNP ᆷ/ETN 날/NNG 이/JKS 기나__1/VV 무/XPN 년__7/NNG 으/JKG 날구__1/VV 디/EC 아니하/VX 오/EF ./SF	보름날이 지나면 연을 날리지 않소.	보름/NNG 날/NNG 이/JKS 지나/VV 면/EC 연/NNG 을/JKO 날리/VV 지/EC 않/VX 소/EC ./SF
사름으느 재빌르 제 머리를 깎지 못하다 나니 니발소에 가서 니발으 합구마.	사름__2/NNG 으느/NNG 재빌르__1/NNG 저/NP 의/JKG 머리/NNG 를/JKO 깎/VV 지/EC 못하/VX 다/EF 나/VV 니/EC 니발__1/NNG 소/NNG 에/JKB 가/VV 어서/EC 니발__1/NNG 으/JKG 합/NNG 구마/EF ./SF	사람은 스스로 자기 머리를 깎지 못하다 보니 이발소에 가서 이발을 합니다.	사람/NNG 은/JX 스스로/MAG 자기/NP 머리/NNG 를/JKO 깎/VV 지/EC 못하/VX 다/EC 보/VX 니/EC 이발소/NNG 에/JKB 가/VV 어서/EC 이발/NNG 을/JKO 하/VV ᆸ니다/EF ./SF
아느새 있다가 가두 일없으니까데 오늘두 영게서 자구 가오. 	아느새__1/NNG 있/VV 다가/EC 가/VV 어두/EC 일/NNG 없/VA 으니까/EC 데/NNB 오늘/NNG 두/JX 영게__1/NP 서/JKB 자/VV 구/EC 가/VV 오/EF ./SF	한동안 있다가 가도 일없으니까 오늘도 여기서 자고 가오. 	한동안/NNG 있/VV 다가/EC 가/VV 어도/EC 일/NNG 없/VA 으니까/EC 오늘/NNG 도/JX 여기/NP 서/JKB 자/VV 고/EC 가/VV 오/EF ./SF
내 해미르 하자구 시자으르 가서 우베르 쌌수다.	나/NP 의/JKG 해미르/NNG 하/VV 자구/EC 시자으르/NNG 가/VV 어서/EC 우베__1/NNG 르/NNG 싸/VV 었/EP 수다/EF ./SF	내가 반찬을 하려고 시장으로 가서 우엉을 샀습니다.	나/NP 가/JKS 반찬/NNG 을/JKO 하/VV 려고/EC 시장/NNG 으로/JKB 가/VV 어서/EC 우엉/NNP 을/JKO 사/VV 었/EP 습니다/EF ./SF
은애르 굽어서 먹으무 과연 맛이 좋습구마.	은애__5/NNG 르/NNG 굽/VA-R 어서/EC 먹/VV 으/EF 무/XPN 과연/MAG 맛/NNG 이/JKS 좋/VA 습/NNG 구마/EF ./SF	은행을 구워서 먹으면 정말 맛이 좋습니다.	은행/NNG 을/JKO 굽/VV-I 어서/EC 먹/VV 으면/EC 정말/MAG 맛/NNG 이/JKS 좋/VA 습니다/EF ./SF
저낙이 데니까데 여레 사림이 우리네게 왓습구마.	$$$ 저/MM 낙/NNG 이/JKS 데/VV 니까/EC 데/NNB 여레/NNG 사림/NNG 이/JKS 우리/NP 너/NP 에게/JKB 오/VV 엇/EP 습/NNG 구마/EF ./SF	저녁이 되니까 여러 사람이 우리 집에 왔습니다.
어시덜이 오래 앉아야 하는데 어시덜 건강이 좋턔내서 자석덜이 박새에두 잠을 못 잔다.	$$$ 어/IC 시/NNG 덜/XSN 이/JKS 오래/MAG 앉/VV 어야/EC 하/VX 는데/EC 어/IC 시/NNG 덜/XSN 건강/NNG 이/JKS 좋/VA 턔/NNG 내/VV 어서/EC 자석/NNG 덜/XSN 이/JKS 박새/NNG 에/JKB 두/JX 잠/NNG 을/JKO 못/MAG 자/VV ᆫ다/EF ./SF	부모가 오래 살아야 하는데 부모의 건강이 좋지 않아서 자식들이 우박에도 잠을 못 잔다.
뎡게 저낙느부리르 보니까데 곱은 새애기 낯이 생각납구마.	뎡게__1/NP 저낙느부리__1/NNG 르/NNG 보/VV 니까/EC 데/NNB 곱/VA-I 은/ETM 새애기__2/NNG 낯/NNG 이/JKS 생각/NNG 납/NNG 구마/EF ./SF	저기 저녁노을을 보니까 고운 새색시 낯이 생각납니다.	저기/NP 저녁노을/NNG 을/JKO 보/VV 니까/EC 곱/VA-I 은/ETM 새색시/NNG 낯/NNG 이/JKS 생각나/VV ᆸ니다/EF ./SF
저 영감이 쌈하구 댕기무 내 그거 말기우지 말구 놔두라구 말합구마.	저/MM 영감/NNG 이/JKS 쌈/NNG 하/XSV 구/EC 댕기__2/VV 무/NNG 내/NNB 그거/NP 말기우__1/VV 지/EC 말/VX 구/EC 놔두/VV 라구/EF 말/NNG 합/NNG 구마/EF ./SF	저 영감이 쌈하고 다니면 내가 그거 말리지 말고 놔두라고 말합니다.	저/MM 영감/NNG 이/JKS 쌈/NNG 하/XSV 고/EC 다니/VV 면/EC 나/NP 가/JKS 그거/NP 말리/VV 지/EC 말/VX 고/EC 놔두/VV 라고/EC 말/NNG 하/XSV ᆸ니다/EF ./SF
겅게 탄쾨 많다.	겅게__1/NP 탄쾨__1/NNG 많/VA 다/EF ./SF	거기에 올가미가 많다.	거기/NP 에/JKB 올가미/NNG 가/JKS 많/VA 다/EF ./SF
동지에느 꼭 오구랑죽으 해 먹습구마. 	동지/NNG 에/JKB 느/NP 꼭/MAG 오구랑죽__1/NNG 으/JKG 해/NNG 먹/VV 습/NNG 구마/EF ./SF	동지에는 꼭 팥죽을 해 먹습니다. 	동지/NNG 에/JKB 는/JX 꼭/MAG 팥죽/NNG 을/JKO 하/VV 어/EC 먹/VV 습니다/EF ./SF
문으 비써 열구 보구 잇는 게 내 안깐이엿습구마. 	문/NNG 으/JKG 비써__1/MAG 열/VV 구/EC 보/VV 구/EC 잇/VV-I 는/ETM 것/NNB 이/JKS 나/NP 의/JKG 안깐이__1/NNG 이/VV 엇/EP 습/NNG 구마/EF ./SF	문을 빼꼼 열고 보고 있는 게 내 아내였습니다. 	문/NNG 을/JKO 빼꼼/MAG 열/VV 고/EC 보/VV 고/EC 있/VX 는/ETM 것/NNB 이/JKS 나/NP 의/JKG 아내/NNG 이/VCP 었/EP 습니다/EF ./SF
노란 빨딱종이르 눈에 대구 하늘으 보니까데 하늘이 노랗게 보입지. 	노랗/VA-I ᆫ/ETM 빨딱종이__1/NNG 르/NNG 눈/NNG 에/JKB 대구/NNP 하늘/NNG 으/JKG 보/VV 니까/EC 데/NNB 하늘/NNG 이/JKS 노랗/VA-I 게/EC 보/VV 입/VV-R 지/EF ./SF	노란 셀로판종이를 눈에 대고 하늘을 보니까 하늘이 노랗게 보이지요. 	노랗/VA-I ᆫ/ETM 셀로판/NNG 종이/NNG 를/JKO 눈/NNG 에/JKB 대/VV 고/EC 하늘/NNG 을/JKO 보/VV 니까/EC 하늘/NNG 이/JKS 노랗/VA-I 게/EC 보이/VV 지요/EF ./SF
그 아매느 스집간 딸이 보개파서 딸으 자꾸 왜웁데.	$$$ 그/IC 아매느/NNG 스집/NNG 가/VV ᆫ/ETM 딸/NNG 이/JKS 보개파서/NNG 딸/NNG 으/JKG 자꾸/MAG 왜웁데/NNG ./SF	그 할머니는 시집간 딸이 보고 싶어서 딸을 자꾸 외데.
즐겁은 시간으 디우구 잇습구마.	즐겁/VA-I 은/ETM 시간/NNG 으/JKG 디우__4/VV 구/EC 잇/VX-R 습/NNG 구마/EF ./SF	즐거운 시간을 보내고 있습니다.	즐겁/VA-I 은/ETM 시간/NNG 을/JKO 보내/VV 고/EC 있/VX 습니다/EF ./SF
물항박에다 쌀으 퍼 오라구 메느리게 시기지.	물항박__1/NNG 에다/JKB 쌀/NNG 으/JKG 푸/VV 어/EC 오/VX 라구/EC 메느리__1/NNG 이/VCP 게/EC 시기__1/VV 지/EF ./SF	물함박에다 쌀을 퍼 오라고 며느리에게 시키지.	물/NNG 함박/NNG 에다/JKB 쌀/NNG 을/JKO 푸/VV 어/EC 오/VX 라고/EC 며느리/NNG 에게/JKB 시키/VV 지/EF ./SF
영게 탄코르 놓았다.	영게__1/NP 탄코__1/NNG 르/NNG 놓/VV 었/EP 다/EF ./SF	여기에 올가미를 놓았다.	여기/NP 에/JKB 올가미/NNG 를/JKO 놓/VV 었/EP 다/EF ./SF
해우래기라 하는 거느 듣기는 들었어두 어찌 생겟는지 내사 모릅지.	해우래기__1/NNG 이/VCP 라/EC 하/VV 는/ETM 거느/NNP 듣기/NNG 는/JX 듣/VV-I 었/EP 어두/EC 어찌/MAG 생/XPN 겟/EP 는지/EC 내사/NNG 모릅지/NNG ./SF	해오라기라 하는 거는 듣기는 들었어도 어찌 생겼는지 나야 모르지요.	해오라기/NNG 이/VCP 라/EC 하/VV 는/ETM 거/NNB 는/JX 듣기/NNG 는/JX 듣/VV-I 었/EP 어도/EC 어찌/MAG 생기/VV 었/EP 는지/EC 나/NP 야/JX 모르/VV 지요/EF ./SF
산에 나무할라 가서 칩우무 벨 쉬 잇소? 그저 어둥불이나 피우구 잇어야디.	산/NNG 에/JKB 나무/NNG 하/XSV ᆯ라/EC 가/VV 어서/EC 칩우무/NNG 벨__9/NNG 쉬__15/NNG 잇/VV-I 소/EC ?/SF 그저/MAG 어둥불__1/NNG 이나/JC 피우/VV 구/EC 잇/VX-R 어야/EC 디/VX ./SF	산에 나무하러 가서 추우면 별 수 있소? 그저 모닥불이나 피우고 있어야지.	산/NNG 에/JKB 나무/NNG 하/XSV 러/EC 가/VV 어서/EC 춥/VA-I 으면/EC 별/MM 수/NNB 있/VA 소/EC ?/SF 그저/MAG 모닥불/NNG 이나/JC 피우/VV 고/EC 있/VX 어야지/EF ./SF
화리르 쏘는 사림이 어저느 없습구마. 	화리__9/NNG 르/NNG 쏘/VV 는/ETM 사림/NNG 이/JKS 어저느/NNG 없/VA 습/NNG 구마/EF ./SF	활을 쏘는 사람이 이제는 없습니다.	활/NNG 을/JKO 쏘/VV 는/ETM 사람/NNG 이/JKS 이제/NNG 는/JX 없/VA 습니다/EF ./SF
지끔두 내 노아매 계옵십구마. 	지끔__2/NNG 두/JX 나/NP 의/JKG 노아매__1/NNG 계옵십구마/NNP ./SF	지금도 나의 증조모가 계십니다.	지금/NNG 도/JX 나/NP 의/JKG 증조모/NNG 가/JKS 계시/VV ᆸ니다/EF ./SF
당시르 하는 사름덜이 개오는 물건으 다 사는 사름이 잇갯슴둥? 	당시__5/NNG 르/NNG 하/VV 는/ETM 사름__2/NNG 덜/XSN 이/JKS 개오__1/VV 는/ETM 물건/NNG 으/JKG 다/MAG 사/VV 는/ETM 사름__2/NNG 이/JKS 잇갯슴둥/NNG ?/SF	장사를 하는 사람들이 가져오는 물건을 다 사는 사람이 있겠습니까?	장사/NNG 를/JKO 하/VV 는/ETM 사람/NNG 들/XSN 이/JKS 가져오/VV 는/ETM 물건/NNG 을/JKO 다/MAG 사/VV 는/ETM 사람/NNG 이/JKS 있/VV 겠/EP 습니까/EF ?/SF
애디르 따다 주겠음?	애디__1/NNG 르/NNG 따/VV 어다/EC 주/VX 겠/EP 음/EF ?/SF	오디를 따다 주겠소?	오디/NNP 를/JKO 따/VV 어다/EC 주/VX 겠/EP 소/EC ?/SF
어느새기 마을이 조용햇는데 요즘은 잔체가 많애서 부따사합구마.	어느새기__1/NNG 마을/NNG 이/JKS 조용/XR 하/XSA 엇/EP 는데/EC 요즘/NNG 은/JX 잔체__2/NNG 가/JKS 많/VA 애서/EC 부따사합구마/NNG ./SF	한동안 마을이 조용했는데 요즘은 잔치가 많아서 부산합니다.	한동안/NNG 마을/NNG 이/JKS 조용/XR 하/XSA 었/EP 는데/EC 요즘/NNG 은/JX 잔치/NNG 가/JKS 많/VA 어서/EC 부산/NNG 하/XSA ᆸ니다/EF ./SF
가달배이무끼느 갈가져서 파지 못합문다.	가달배이무끼__1/NNG 느/NP 가/VV ᆯ/ETM 가지/VV 어서/EC 파지/NNG 못/MAG 합문/NNG 다/MAG ./SF	가랑무는 갈라져서 팔지 못합니다.	가랑/NNG 무/NNG 는/JX 갈라지/VV 어서/EC 팔/VV 지/EC 못하/VX ᆸ니다/EF ./SF
내 메느리게 서답하라구 시겟습구마. 	나/NP 의/JKG 메느리__1/NNG 이/VCP 게/EC 서답하__1/VV 라구/EF 이/VCP 시/EP 겟/EP 습/NNG 구마/EF ./SF	내가 며느리에게 빨래하라고 시켰습니다. 	나/NP 가/JKS 며느리/NNG 에게/JKB 빨래/NNG 하/XSV 라고/EC 시키/VV 었/EP 습니다/EF ./SF
아덜이 뎡말 강말꾸러기다.	아__23/NNG 덜/XSN 이/JKS 뎡/NNG 말/NNG 강말꾸러기__1/NNG 이/VCP 다/EF ./SF	아이들이 정말 말썽꾸러기다.	아이/NNG 들/XSN 이/JKS 정말/MAG 말썽꾸러기/NNG 이/VCP 다/EF ./SF
댱꼬 있기사 있습디.	댱꼬__1/NNG 있/VA 기사/NNG 있/VA 습/NNG 디/EF ./SF	장끼가 있기야 있지요.	장끼/NNG 가/JKS 있/VV 기/ETN 야/JX 있/VV 지요/EF ./SF
가슬을 하구 그담에느 맏질을 합구마. 	가슬__1/NNG 을/JKO 하/VV 구/EC 그/MM 담/NNG 에/JKB 느/NP 맏질__1/NNG 을/JKO 합구마/NNG ./SF	가을걷이를 하고 그담에는 마당질을 합니다. 	가을걷이/NNG 를/JKO 하/VV 고/EC 그/MM 담/NNG 에/JKB 는/JX 마당/NNG 질/XSN 을/JKO 하/VV ᆸ니다/EF ./SF
정게 잇는 게 원시이 아이오?	정게__2/NP 잇/VV-I 는/ETM 것/NNB 이/JKS 원시이__1/NNG 아이__12/MAG 오/EF ?/SF	저기 있는 게 원숭이 아니오?	저기/NP 있/VV 는/ETM 것/NNB 이/JKS 원숭이/NNG 아니/VCN 오/EF ?/SF
거래 내 일우 거두비치지 말라우.	거래__6/NP 내/MM 일/NNG 우/NNG 거두비치__1/VV 지/EC 말/VX 라우/EF ./SF	당신 내 일을 방해하지 마오.	당신/NP 나/NP 의/JKG 일/NNG 을/JKO 방해/NNG 하/XSV 지/EC 말/VX 오/EF ./SF
내 바씨 한갑을 세는 나 댓습구마. 	나/NP 의/JKG 바씨__1/MAG 한/MM 갑/NNG 을/JKO 세__21/VV 는/ETM 나/NP 댓/NR 습/NNG 구마/EF ./SF	내가 벌써 환갑을 쇠는 나이가 됐습니다. 	나/NP 가/JKS 벌써/MAG 환갑/NNG 을/JKO 쇠/VV 는/ETM 나이/NNG 가/JKC 되/VV 었/EP 습니다/EF ./SF
나무새느 양념으 넣구 메워서 먹습구마.	나무새__3/NNG 느/NP 양념/NNG 으/NNG 넣/VV 구/EC 메우/VV 어서/EC 먹/VV 습/NNG 구마/EF ./SF	남새는 양념을 넣고 무쳐서 먹습니다.	남/NNG 새/NNG 는/JX 양념/NNG 을/JKO 넣/VV 고/EC 무치/VV 어서/EC 먹/VV 습니다/EF ./SF
마른 검브리르 모아셔 불우 지펬다.	마르/VV ᆫ/ETM 검브리__1/NNG 르/NNG 모으/VV 어/EC 시/VA 어/EC 불우/NNG 지펬/NNG 하/XSA 다/EF ./SF	마른 검불을 모아서 불을 지폈다.	마르/VV ᆫ/ETM 검불/NNG 을/JKO 모으/VV 어서/EC 불/NNG 을/JKO 지피/VV 었/EP 다/EF ./SF
내 가진 돈으 싹 동미게 앳기웟습구마. 	나/NP 의/JKG 가지/VV ᆫ/ETM 돈/NNG 으/JKG 싹/NNG 동미__1/NNG 이/VCP 게/EC 앳기웟습구마/NNG ./SF	내가 가진 돈을 싹 동무에게 앗겼습니다. 	나/NP 가/JKS 가지/VV ᆫ/ETM 돈/NNG 을/JKO 싹/MAG 동무/NNG 에게/JKB 앗/IC 기/VV 었/EP 습니다/EF ./SF
넷날 집으 마수구 지끔 사는 집으 새로 젓습구마.	넷/NR 날/NNG 집/VV-R 으/EC 마수__1/VV 구/EC 지끔__2/NNG 사/VV 는/ETM 집/NNG 으/JKG 새로/MAG 젓/VV-I 습/NNG 구마/EF ./SF	옛날 집을 부수고 지금 사는 집을 새로 지었습니다.	옛날/NNG 집/NNG 을/JKO 부수/VV 고/EC 지금/MAG 사/VV 는/ETM 집/NNG 을/JKO 새로/MAG 짓/VV-I 었/EP 습니다/EF ./SF
너 어마니게 자꾸 항역질하무 혼난다.	너/NP 어마니게/NNG 자꾸/MAG 항역질하__1/VV 무/NNG 혼나/VV ᆫ다/EF ./SF	너 어머니에게 자꾸 말대꾸하면 혼난다.	너/NP 어머니/NNG 에게/JKB 자꾸/MAG 말대꾸/NNG 하/XSV 면/EC 혼나/VV ᆫ다/EF ./SF
외누이느 보통 사름마 사는 게 불편하갯습지. 	외누이__1/NNG 느/NP 보통/NNG 사름__2/NNG 마/NNG 사/VV 는/ETM 것/NNB 이/JKS 불편/NNG 하/XSA 개/VV 엇/EP 습지/NNG ./SF	애꾸눈은 보통 사람보다 사는 게 불편하겠지요. 	애꾸눈/NNG 은/JX 보통/NNG 사람/NNG 보다/JKB 사/VV 는/ETM 것/NNB 이/JKS 불편/NNG 하/XSA 겠/EP 지요/EF ./SF
무슨 물건으 많이 싸딜이자구 함두?	무슨/MM 물건/NNG 으/JKG 많이/MAG 싸딜이__1/VV 자구/EC 하/VV ᆷ/EF 두/MM ?/SF	무슨 물건을 많이 사들이자고 합니까?	무슨/MM 물건/NNG 을/JKO 많이/MAG 사들이/VV 자고/EC 하/VV ᆸ니까/EF ?/SF
날이 저물무 쉐르 모싯간에 딜에 매구 저낙모시르 줘야 돼디.	$$$ 날/NNG 이/JKS 저물/VV ᆯ/ETM 무/NNG 쉐르/NNG 모싯/NNG 간/NNB 에/JKB 딜/NNG 에/JKB 매/VV 구/EC 저낙모시르/NNG 주/VV 어야/EC 되/VV 어/EF 디/NNG ./SF	날이 저물면 소를 외양간에 들여 매고 저녁 여물을 줘야 되지.
그 음슥 맛이 어쩐지 내느 한나투 모릅구마.	그/IC 음슥__1/NNG 맛/NNG 이/JKS 어쩐지/MAG 내느/NNG 한나__2/NR 투/NR 모릅구마/NNG ./SF	그 음식 맛이 어떤지 나는 하나도 모릅니다.	그/IC 음식/NNG 맛/NNG 이/JKS 어떻/VA-I ᆫ지/EC 나/NP 는/JX 하나/NR 도/JX 모르/VV ᆸ니다/EF ./SF
따아 파는 거 강차위라구 하압구마.	따/VV 어/EC 파/VV 는/ETM 거/NNB 강/NNG 차/NNG 위/NNG 이/VCP 라구/EC 하/VV 압/NNG 구마/EF ./SF	땅을 파는 걸 강차위라고 합니다.	땅/NNG 을/JKO 파/VV 는/ETM 걸/NNG 강/NNG 차/NNG 위/NNG 이/VCP 라고/EC 하/VV ᆸ니다/EF ./SF
그 사름은 키두 쪼끄맣구 손가 발두 작은데 머리만 크다 나니 딱 떡메골입구마. 	그/MM 사름__2/NNG 은/JX 키/NNG 두/JX 쪼끄맣/VA-I 구/EC 손/NNG 가/NNG 발/NNG 두/JX 작/VA 은데/EC 머리/NNG 만/JX 크/VA 다/EF 나/VV 니/EC 딱/MAG 떡메골__1/NNG 입/VV-R 구/EC 말/VX 어/EF ./SF	그 사람은 키도 쪼끄맣고 손과 발도 작은데 머리만 크다 보니 딱 대갈장군입니다.	그/MM 사람/NNG 은/JX 키/NNG 도/JX 쪼끄맣/VA-I 고/EC 손/NNG 과/JC 발/NNG 도/JX 작/VA 은데/EC 머리/NNG 만/JX 크/VA 다/EC 보/VX 니/EC 딱/MAG 대/VV 어/EC 가/VX ᆯ/ETM 장군/NNG 이/VCP ᆸ니다/EF ./SF
내 내기르 들어 봅소.	나/NP 의/JKG 내기__12/NNG 르/NNG 들/VV 어/EC 봅소/NNG ./SF	내 이야기를 들어 보세요.	나/NP 의/JKG 이야기/NNG 를/JKO 듣/VV-I 어/EC 보/VX 세요/EF ./SF
입쌀르 지은 밥우느 이팝이라구 하오.	입쌀/NNG 르/NNG 짓/VV-I 은/ETM 밥우느/NNG 이팝__1/NNG 이/VCP 라구/EC 하/VV 오/EF ./SF	입쌀로 지은 밥은 이밥이라고 하오.	입쌀/NNG 로/JKB 짓/VV-I 은/ETM 밥/NNG 은/JX 이/MM 밥/NNG 이/VCP 라고/EC 하/VV 오/EF ./SF
부시때기를 아궁이에 꽂아 두무 아이 됨메.	부시때기__1/NNG 를/JKO 아궁이/NNG 에/JKB 꽂/VV 어/EC 두무/NNG 아이/NNG 됨메/NNG ./SF	부지깽이를 아궁이에 꽂아 두면 안 되네.	부지깽이/NNG 를/JKO 아궁이/NNG 에/JKB 꽂/VV 어/EC 두/VX 면/EC 안/MAG 되/VV 네/EF ./SF
손군덜이 어레실 적에느 앙귀르 쓰구 기랫습구마. 	손군__1/NNG 덜/XSN 이/JKS 어레/NNG 이/VCP 시/EP ᆯ/ETM 적/NNB 에/JKB 느/NP 앙귀__2/NNG 르/NNG 쓰/VV 구/EC 기랫습구마/NNG ./SF	손자들이 어렸을 적에는 떼를 쓰고 그랬습니다.	손자/NNG 들/XSN 이/JKS 어리/VA 었/EP 을/ETM 적/NNB 에/JKB 는/JX 떼/NNG 를/JKO 쓰/VV 고/EC 그렇/VA-I 었/EP 습니다/EF ./SF
치얘 다 빠디다 나이 제구 밥으 먹습구마.	치얘__1/NNG 다/MAG 빠디다/NNG 나이/NNG 제구__1/MAG 밥/NNG 으/JKG 먹/VV 습/NNG 구마/EF ./SF	치아가 다 빠지다 보니 겨우 밥을 먹습니다.	치아/NNG 가/JKS 다/MAG 빠지/VV 다/EC 보/VX 니/EC 겨우/MAG 밥/NNG 을/JKO 먹/VV 습니다/EF ./SF
지끔이사 없어두 내 어려실 적에느 머리에 니 많앳습구마.	지끔__2/NNG 이사/JX 없/VA 어두/EC 내/MM 어리/VA 어/EC 시/EP ᆯ/ETM 적/NNB 에/JKB 느/NP 머리/NNG 에/JKB 니__4/NNG 많앳습구마/NNG ./SF	지금이야 없어도 내가 어렸을 적에는 머리에 이가 많았습니다.	지금/NNG 이야/JX 없/VA 어도/EC 나/NP 가/JKS 어리/VA 었/EP 을/ETM 적/NNB 에/JKB 는/JX 머리/NNG 에/JKB 이/NNG 가/JKS 많/VA 었/EP 습니다/EF ./SF
내 다치운 게 운던수 탓이라구 어기멕엤습구마.	$$$ 나/NP 의/JKG 다/MAG 치우/VV ᆫ/ETM 것/NNB 이/JKS 운/NNG 던/ETM 수/NNB 탓/NNG 이/VCP 라구/EF 어기멕엤습구마/NNP ./SF	내가 다친 게 운전수 탓이라고 억지 부리며 우겨댔습니다.
일으 할 적에 이꽝조꽝 그리 서거푸게 일으 하무 대접으 한마디두 못 받습지.	일/NR 으/IC 하/VV ᆯ/ETM 적/NNB 에/JKB 이꽝조꽝__1/MAG 그리/MAG 서거푸게/NNG 일/NR 으/IC 하/IC 무/NNG 대접/NNG 으/JKG 한마디/NNG 두/JX 못/MAG 받/VV-R 습지/NNG ./SF	일을 할 적에 허둥지둥 그리 어설프게 일을 하면 대접을 하나도 못 받지요.	일/NNG 을/JKO 하/VV ᆯ/ETM 적/NNB 에/JKB 허둥지둥/MAG 그리/MAG 어설프/VA 게/EC 일/NNG 을/JKO 하/VV 면/EC 대접/NNG 을/JKO 하나/NR 도/JX 못/MAG 받/VV-R 지요/EF ./SF
옛날에느 둥굴쇄 없으무 밭을 못 갈앗소다. 	옛날/NNG 에/JKB 느/NP 둥굴쇄__1/NNG 없/VA 으/EF 무/NNG 밭/NNG 을/JKO 못/MAG 갈/VV 엇/EF 소/NNG 이/VCP 다/EF ./SF	옛날에는 황소 없으면 밭을 못 갈았습니다.	옛날/NNG 에/JKB 는/JX 황소/NNG 없/VA 으면/EC 밭/NNG 을/JKO 못/MAG 갈/VV 었/EP 습니다/EF ./SF
어레실 적에 자란이덜터르 한다구 사기깨디개 가주구 바꿈재놀옴으 햇습구마.	어레/NNG 이/VCP 시/EP ᆯ/ETM 적/NNB 에/JKB 자란이덜터르/NNG 하/VV ᆫ다구/EF 사기깨디개__1/NNG 가주/VX 구/EC 바꿈재놀옴으/NNG 하/XSV 엇/EP 습/NNG 구마/EF ./SF	어렸을 적에 성인들처럼 한다고 사금파리 가지고 소꿉놀이를 했습니다.	어리/VA 었/EP 을/ETM 적/NNB 에/JKB 성인/NNG 들/XSN 처럼/JKB 하/VX ᆫ다고/EC 사금/NNG 파리/NNG 가지/VV 고/EC 소꿉놀이/NNG 를/JKO 하/VV 었/EP 습니다/EF ./SF
가 재별스럽다구 사름덜이 자주루 말합지.	$$$ 가/XPN 재/XPN 별스럽/VA-I 다구/EF 사름/NNG 덜/XSN 이/JKS 자주루/NNG 말/NNG 합/NNG 지/EF ./SF	그 아이 별스럽다고 사람들이 자주 말하지요.
호뒤라는 말으느 작게 씁지. 	호뒤__1/NNG 이/VCP 라는/ETM 말으느/NNG 작/VA 게/EC 씁__1/VA 지/EF ./SF	호두라는 말은 적게 쓰지요.	호두/NNG 이/VCP 라는/ETM 말/NNG 은/JX 적/VA 게/EC 쓰/VV 지요/EF ./SF
넷날에느 나랏님으 임굼이라구두 햇습구마.	넷날에느/NNG 나랏님/NNG 으/JKG 임굼__1/NNG 이/VCP 라/EC 구두/NNG 하/XSV 엇/EP 습/NNG 구마/EF ./SF	옛날에는 나라님을 임금이라고도 했습니다.	옛날/NNG 에/JKB 는/JX 나라/NNG 님/XSN 을/JKO 임금/NNG 이/VCP 라고/EC 도/JX 하/VV 었/EP 습니다/EF ./SF
장마다에 가서 뇡이르 쌌다.	장/NNG 마다/JX 에/JKB 가/VV 어서/EC 뇡이__1/NNG 르/NNG 싸/VV 었/EP 다/EF ./SF	장에 가서 자두를 샀다.	장/NNG 에/JKB 가/VV 어서/EC 자두/NNG 를/JKO 사/VV 었/EP 다/EF ./SF
사비가 나느 떡을르 시걱으 에웟습구마. 	사비__10/NNG 가/JKS 나느/NNG 떡/NNG 을/JKO 르/NNG 시걱__1/NNG 으/JKG 에웟습구마/NNG ./SF	사위와 나는 떡으로 끼니를 때웠습니다. 	사위/NNG 와/JC 나/NP 는/JX 떡/NNG 으로/JKB 끼니/NNG 를/JKO 때우/VV 었/EP 습니다/EF ./SF
밤에 캄캄하무 옛날에사 햇불으 들구 댕겟습지. 	밤/NNG 에/JKB 캄캄/MAG 하/XSA 무/NNG 옛날/NNG 에/JKB 사/NR 햇불__1/NNG 으/JKG 들/VV 구/EC 댕겟/NNG 습지/NNG ./SF	밤에 캄캄하면 옛날에야 횃불을 들고 다녔지요.	밤/NNG 에/JKB 캄캄/MAG 하/XSA 면/EC 옛날/NNG 에/JKB 야/JX 횃불/NNG 을/JKO 들/VV 고/EC 다니/VV 었/EP 지요/EF ./SF
동생으 어드르 서방보냄둥?	동생/NNG 으/NNG 어드르/NNP 서방/NNG 보내/VV ᆷ/ETN 둥/NNB ?/SF	동생을 어디로 장가들입니까?	동생/NNG 을/JKO 어디/NP 로/JKB 장가/NNG 들/XSN 이/VCP ᆸ니까/EF ?/SF
우리 아바지느 왜큰아바니 집에 오무 꼭 절을 시기메 녜절으 가르치더란 말이오.	$$$ 우리/NP 아바지느/NNP 왜큰아바니/NNG 집/NNG 에/JKB 오/NR 무/NNG 꼭/MAG 절/NNG 을/JKO 시기메/NNG 녜절으/NNG 가르치/VV 더란/ETM 말/NNG 이/VCP 오/EF ./SF	우리 아버지는 외할아버지께서 집에 오시면 꼭 절을 시키며 가르치더란 말이오.
산에 낭기 감뿍 잇엇습구마. 	산/NNG 에/JKB 낭기__1/NNG 감뿍__1/MAG 잇/NNG 엇/EP 습/NNG 구마/EF ./SF	산에 나무가 잔뜩 있었습니다. 	산/NNG 에/JKB 나무/NNG 가/JKS 잔뜩/MAG 있/VV 었/EP 습니다/EF ./SF
헝것이 없으무 겥집에 가서 빌기무 뎁구마. 	헝것__1/NNG 이/JKS 없/VA 으/EC 무/XPN 겥/NNG 집/NNG 에/JKB 가/VV 어서/EC 빌기__1/VV 무/NNG 뎁구마/NNG ./SF	헝겊이 없으면 이웃집에 가서 빌리면 됩니다. 	헝겊/NNG 이/JKS 없/VA 으면/EC 이웃집/NNG 에/JKB 가/VV 어서/EC 빌리/VV 면/EC 되/VV ᆸ니다/EF ./SF
겨슬 남세기는 걱정 없스꾸마.	겨/NNG 슬/MAG 남세기__1/NNG 는/ETM 걱정/NNG 없스꾸마/NNG ./SF	겨울 양식은 걱정 없습니다.	겨울/NNG 양식/NNG 은/JX 걱정/NNG 없/VA 습니다/EF ./SF
영게 물으 마시구 목으 제치구 가오.	영게__1/NP 물/NNG 으/JKG 마시/VV 구/EC 목/NNG 으/JKG 제치__6/VV 구/EC 가/VV 오/EF ./SF	여기 물을 마시고 목을 축이고 가오.	여기/NP 물/NNG 을/JKO 마시/VV 고/EC 목/NNG 을/JKO 축이/VV 고/EC 가/VV 오/EF ./SF
자닷한 글씨느 나느 나이 많애서 잘 베우대냅구마. 	$$$ 자/IC 닷/MM 한/MM 글씨느/NNG 나느/NNG 나이/NNG 많/VA 애서/EC 잘/MAG 베우대냅구마/NNG ./SF	자잘한 글씨는 나는 나이가 많아서 잘 보이지 않습니다. 
그 할아바지는 도채기라 다숭지도 혼분자만 먹는다.	그/IC 하/VV ᆯ/ETM 아/IC 바지/NNG 는/JX 도채기__1/NNG 이/VCP 라/EC 다숭지__1/NNG 도/JX 혼/NNG 분자/NNG 만/JX 먹/VV 는다/EF ./SF	그 할아버지는 욕심쟁이라 누룽지도 혼자만 먹는다.	그/MM 할아버지/NNG 는/JX 욕심/NNG 쟁이/XSN 이/VCP 라/EC 누룽지/NNG 도/JX 혼자/NNG 만/JX 먹/VV 는다/EF ./SF
도투 인치 잡아야 합구마.	도투__1/NNG 인치__4/MAG 잡/VV-R 어야/EC 합/NNG 구마/EF ./SF	돼지를 이내 잡아야 합니다.	돼지/NNG 를/JKO 이내/MAG 잡/VV-R 어야/EC 하/VX ᆸ니다/EF ./SF
아즉 먹어 아이 보았소.	아즉__2/MAG 먹/VV 어/EC 아이/NNG 보/VV 었/EP 소/EC ./SF	아직 먹어 보지 않았소.	아직/MAG 먹/VV 어/EC 보/VX 지/EC 않/VX 었/EP 소/EC ./SF
춤이 입에서 줄줄 흘르구 잇다나니 내 씻으라구 말햇습구마. 	$$$ 춤/NNG 이/JKS 입/NNG 에서/JKB 줄줄/MAG 흘르/VV 구/EC 잇/VX-R 다/EF 나/VV 니/EC 나/NP 의/JKG 씻/VV-R 으라구/EC 말/NNG 하/XSV 엇/EP 습/NNG 구마/EF ./SF	침이 입에서 줄줄 흐르고 있다 보니 내가 씻으라고 말했습니다.
영게 잇는 우이르 듭소.	영게__1/NP 잇/VV-I 는/ETM 우이__10/NNG 르/NNG 듭소/NNG ./SF	여기 있는 우유를 드세요.	여기/NP 있/VV 는/ETM 우유/NNG 를/JKO 드세/VA 어요/EF ./SF
펜지르 부틸라무 우페 치우라 잇어야 합구마.	펜지르/NNG 부틸라무/NNG 우페__1/NNG 치우/VV 라/EC 잇/VX-R 어야/EC 합/NNG 구마/EF ./SF	편지를 부치려면 우표가 꼭 있어야 합니다.	편지/NNG 를/JKO 부치/VV 려면/EC 우표/NNG 가/JKS 꼭/MAG 있/VV 어야/EC 하/VX ᆸ니다/EF ./SF
날이 지내 덥으니 일으 하지 말구 지끔 정게 넝다례 가서 조꼼 늡어 쉐라.	날/NNG 이/JKS 지내/VV 어/EC 덥/VA-I 으니/EC 일/NNG 으/JKG 하/VV 지/EC 말/VX 구/EC 지끔__2/NNG 정게__2/NP 넝다례/NNG 가/VV 어서/EC 조꼼__1/NNG 늡어/NNG 쉐__2/VV 라/EF ./SF	날이 너무 더우니 일을 하지 말고 지금 저기 응달에 가서 조금 누워 쉬어라.	날/NNG 이/JKS 너무/MAG 덥/VA-I 으니/EC 일/NNG 을/JKO 하/VV 지/EC 말/VX 고/EC 지금/MAG 저기/NP 응달/NNG 에/JKB 가/VV 어서/EC 조금/MAG 눕/VV-I 어/EC 쉬/VV 어라/EF ./SF
먼 데서 손님이 왓는데 무스거 뇨리라구 벤벤한 게 없습구마.	멀/VA ᆫ/ETM 데/NNB 서/JKB 손/NNG 님/XSN 이/JKS 오/VV 엇/EP 는데/EC 무스거/NNG 뇨리__1/NNG 이/VCP 라구/EC 베/VV ᆫ/ETM 베/VV ᆫ/ETM 하/XSV ᆫ/ETM 것/NNB 이/JKS 없/VA 습/NNG 구마/EF ./SF	먼 데서 손님이 왔는데 무슨 요리라고 변변한 것이 없습니다.	멀/VA ᆫ/ETM 데/NNB 서/JKB 손/NNG 님/XSN 이/JKS 오/VV 었/EP 는데/EC 무슨/MM 요리/NNG 이/VCP 라고/EC 변변/XR 하/XSA ᆫ/ETM 것/NNB 이/JKS 없/VA 습니다/EF ./SF
수에 크기사 이닷하구 갈치느 그거보구 큽구마. 	수에__2/NNG 크기/NNG 사/NR 이닷하__2/VA 구/EC 갈치/NNG 느/NP 그거/NP 보/VV 구/EC 큽구마/NNG ./SF	숭어 크기야 이만하고 갈치는 그거보다 큽니다. 	숭어/NNG 크기/NNG 이/VCP 야/EF 이만/XR 하/XSA 고/EC 갈치/NNG 는/JX 그거/NP 보다/JKB 크/VA ᆸ니다/EF ./SF
내 어레실 적에 헤이가 내 헤에데서 아즈바니느 보두두 못하엿습구마. 	나/NP 의/JKG 어레/NNG 이/VCP 시/EP ᆯ/ETM 적/NNB 에/JKB 헤이/IC 가/JKS 나/NP 의/JKG 헤에/IC 데/NNB 서/JKB 아즈바니__4/NNG 느/NP 보두두/NNG 못/MAG 하/VV 엇/EP 습/NNG 구마/EF ./SF	내 어렸을 적에 언니와 내가 헤어져서 형부는 보지도 못하였습니다. 	내/MM 어리/VA 었/EP 을/ETM 적/NNB 에/JKB 언니/NNG 와/JC 나/NP 가/JKS 헤어지/VV 어서/EC 형부/NNG 는/JX 보/VV 지/EC 도/JX 못/MAG 하/VV 었/EP 습니다/EF ./SF
돈으 뀌우무 니자두 물어야 합구마.	돈/NNG 으/JKG 뀌우무/NNG 니자__1/NNG 두/JX 물/VV 어야/EC 합/NNG 구마/EF ./SF	돈을 꾸면 이자도 물어야 합니다.	돈/NNG 을/JKO 꾸/VV 면/EC 이자/NNG 도/JX 물/VV 어야/EC 하/VX ᆸ니다/EF ./SF
저 아 쪼꼬마터무 죽을 뻔햇습구마. 	저/MM 아__23/NNG 쪼꼬마터무__1/MAG 죽/VV 을/ETM 뻔/NNB 하/XSA 엇/EP 습/NNG 구마/EF ./SF	저 아이 하마터면 죽을 뻔했습니다. 	저/MM 아이/NNG 하마터면/MAG 죽/VV 을/ETM 뻔/NNB 하/XSA 었/EP 습니다/EF ./SF
쉐 술기르 꾸수구 댕기는 거느 어전 없습구마.	쉐__4/NNG 술기__1/NNG 르/NNG 꾸수__1/VV 구/EC 댕기__2/VV 는/ETM 거느/NNP 어/IC 전/MM 없/VA 습/NNG 구마/EF ./SF	소가 수레를 끌고 다니는 거는 이제는 없습니다.	소/NNG 가/JKS 수레/NNG 를/JKO 끌/VV 고/EC 다니/VV 는/ETM 거/NNB 는/JX 이제/NNG 는/JX 없/VA 습니다/EF ./SF
야듬목이사 에레실 적에 낫구 지끔은 아이 나오. 	야듬목__1/NNG 이사/NNG 에레/NNP 시/EP ᆯ/ETM 적/NNB 에/JKB 낫/VV-I 구/EC 지끔__2/NNG 은/JX 아이__12/MAG 나/VV 오/EF ./SF	여드름이야 어렸을 적에 났고 지금은 아니 나오.	여드름/NNG 이야/JX 어리/VA 었/EP 을/ETM 적/NNB 에/JKB 나/VV 었/EP 고/EC 지금/NNG 은/JX 아니/MAG 나/VV 오/EF ./SF
칩우니까데 동삼에 움질르 가는 사름우느 한나투 없습지.	칩우니까데/NNP 동/MM 삼/NR 에/JKB 움/NNG 질/XSN 르/NNG 가/VV 는/ETM 사름__2/NNG 우느/NNG 한나__2/NR 투/NR 없/VA 습지/NNG ./SF	추우니까 겨울에 음지로 가는 사람은 하나도 없지요.	춥/VA-I 으니까/EC 겨울/NNG 에/JKB 음지/NNG 로/JKB 가/VV 는/ETM 사람/NNG 은/JX 하나/NR 도/JX 없/VA 지요/EF ./SF
내 늙어서 가즈난아르 재래우는 게 지내 바쁩구마.	나/NP 의/JKG 늙/VV 어서/EC 가즈난아__1/NNG 르/NNG 재래/NNG 울/VV 는/ETM 것/NNB 이/VCP 지/EC 나/NP 의/JKG 바쁩구마/NNG ./SF	내가 늙어서 갓난아이를 키우는 게 너무 어렵습니다.	나/NP 가/JKS 늙/VV 어서/EC 갓난아이/NNG 를/JKO 키우/VV 는/ETM 것/NNB 이/JKS 너무/MAG 어렵/VA-I 습니다/EF ./SF
남우 집에서 적간살이르 하메 사는 사림이 지끔두 잇기는 하오.	남우/NNG 집/NNG 에서/JKB 적간살이__1/NNG 르/NNG 하메/NNG 사/NNG 는/JX 사림/NNG 이/JKS 지끔__2/NNG 두/JX 잇/VV-I 기/ETN 는/JX 하/VX 오/EF ./SF	남의 집에서 행랑살이를 하며 사는 사람이 지금도 있기는 하오.	남/NNG 의/JKG 집/NNG 에서/JKB 행랑살이/NNG 를/JKO 하/VV 며/EC 사/VV 는/ETM 사람/NNG 이/JKS 지금/NNG 도/JX 있/VV 기/ETN 는/JX 하/VX 오/EF ./SF
내 펜지르 쓰무 꼭 헤답을 하오. 	나/NP 의/JKG 펜/NNG 지르/VV 쓰무/NNG 꼭/MAG 헤답__1/NNG 을/JKO 하/VV 오/EF ./SF	내가 편지를 쓰면 꼭 회답을 하오.	나/NP 가/JKS 편지/NNG 를/JKO 쓰/VV 면/EC 꼭/MAG 회답/NNG 을/JKO 하/VV 오/EF ./SF
올해느 지내 가물어서 베 이파기꺼지 다 말랏습지.	올해느/NNG 지내/VV 어/EC 가물/VV 어서/EC 베__6/NNG 이파기__1/NNG 꺼지/VV 다/EC 마르/VV 엇/EP 습지/NNG ./SF	올해는 너무 가물어서 벼 이파리까지 다 말랐지요.	올해/NNG 는/JX 너무/MAG 가물/VV 어서/EC 벼/NNG 이파리/NNG 까지/JX 다/MAG 마르/VV 었/EP 지요/EF ./SF
고 개지르 보니까데 대가리부터 꼬리미꺼지 시꺼멓습더구마. 	고/MM 개지__3/NNG 르/NNG 보/VV 니까/EC 데/NNB 대가리/NNG 부터/JX 꼬리미__1/NNG 꺼지/VV 시꺼멓/VA-I 습/NNG 더/EP 구마/EF ./SF	고 강아지를 보니까 대가리부터 꼬리까지 시꺼멓더군요.	고/MM 강아지/NNG 를/JKO 보/VV 니까/EC 대가리/NNG 부터/JX 꼬리/NNG 까지/JX 시꺼멓/VA-I 더군요/EF ./SF
지하 오래비 안깐이느 올찌시미라 하오.	지하/NNG 오래비/NNG 안/MAG 깔/VV ᆫ/ETM 이/MM 느/NP 올찌시미__1/NNG 이/VCP 라/EC 하/VV 오/EF ./SF	손아래 남동생 부인은 올케라 하오.	손아래/NNG 남동생/NNG 부인/NNG 은/JX 올케/NNG 이/VCP 라/EC 하/VV 오/EF ./SF
왜손지느 셔바아 언제 갓슴두?	왜손지__1/NNG 느/NP 셔바아/NNG 언제/MAG 갓슴두/NNG ?/SF	외손자는 장가를 언제 갔습니까?	외손자/NNG 는/JX 장가/NNG 를/JKO 언제/MAG 가/VV 었/EP 습니까/EF ?/SF
내 회미르 잃어뿌레서 얼매나 바빳는지 모릅지? 	나/NP 의/JKG 회미__2/NNG 르/NNG 잃어뿌레서/NNG 얼매__1/NNG 나/JX 바쁘/VA 엇/EP 는지/EC 모릅지/NNG ?/SF	내가 호미를 잃어버려서 얼마나 힘들었는지 모르지요? 	나/NP 가/JKS 호미/NNG 를/JKO 잃어버리/VV 어서/EC 얼마나/MAG 힘들/VA 었/EP 는지/EC 모르/VV 지요/EF ?/SF
내 일이 많애서 하르두 쉬지 못하구 그래다나이까데 바뿌오.	$$$ 나/NP 의/JKG 일/NNG 이/JKS 많/VA 애서/EC 하르두/NNG 쉬/VV 지/EC 못하/VX 구/EC 그래다나이까데/NNG 바뿌오/NNG ./SF	내가 일이 많아서 하루도 쉬지 못하고 그러다 보니 힘드오.
내가 말테 딴 동미 말테르 내 애끼 흉내구 다니오. 	나/NP 가/JKS 말테__1/NNG 딴/MM 동미__1/NNG 말테__1/NNG 르/NNG 나/NP 의/JKG 애끼__1/NNG 흉내__1/VV 구/EC 다니/VV 오/EF ./SF	나와 말투가 다른 동무의 말투를 내 아우가 흉내질하고 다니오.	나/NP 와/JC 말투/NNG 가/JKS 다른/MM 동무/NNG 의/JKG 말투/NNG 를/JKO 나/NP 의/JKG 아우/NNG 가/JKS 흉내/NNG 질/XSN 하/XSV 고/EC 다니/VV 오/EF ./SF
녜펜네느 말이 많으무 아이 된다.	녜펜네__1/NNG 느/NP 말/NNG 이/JKS 많/VA 으/EF 무/XPN 아이/NNG 되/VV ᆫ다/EF ./SF	여편네는 말이 많으면 안 된다.	여편네/NNG 는/JX 말/NNG 이/JKS 많/VA 으면/EC 안/MAG 되/VV ᆫ다/EF ./SF
우리네느 항세두 없구 달기두 없엇습구마. 	우리/NP 네/XSN 느/NP 항세__2/NNG 두/JX 없/VA 구/EC 달/VV 기/ETN 두/JX 없/VA 엇/EP 습/NNG 구마/EF ./SF	우리네는 황소도 없고 닭도 없었습니다.	우리/NP 네/XSN 는/JX 황소/NNG 도/JX 없/VA 고/EC 닭/NNG 도/JX 없/VA 었/EP 습니다/EF ./SF
낭글르 맨든 달기 예계지 산 거 가툴합구마.	낭/NNG 글/NNG 르/NNG 맨들/VV ᆫ/ETM 달/VV 기/ETN 예계지__1/MAG 살/VV ᆫ/ETM 거/NNB 가툴합구마/NNG ./SF	나무로 만든 닭이 마치 산 거 같습니다.	나무/NNG 로/JKB 만들/VV ᆫ/ETM 닭/NNG 이/JKS 마치/MAG 살/VV ᆫ/ETM 거/NNB 같/VA 습니다/EF ./SF
성제다나이 서르 잘 돕아주구 그랫습지. 	성제__9/NNG 다/MAG 나이/NNG 서르/NNG 잘/MAG 돕/VV-I 어/EC 주/VX 구/EC 그렇/VA-I 엇/EP 습지/NNG ./SF	형제니까 서로 잘 도와주고 그랬지요. 	형제/NNG 이/VCP 니까/EC 서로/MAG 잘/MAG 돕/VV-I 어/EC 주/VX 고/EC 그렇/VA-I 었/EP 지요/EF ./SF
핵교 마감하기 전에느 집에 돌아올 호게두 두디 말아라. 	핵교__1/NNG 마감/NNG 하/XSV 기/ETN 전/NNG 에/JKB 느/NP 집/NNG 에/JKB 돌아오/VV ᆯ/ETM 호게__2/NNG 두/JX 두/VV 디/EC 말/VX 어라/EF ./SF	학교가 마감하기 전에는 집에 돌아올 엄두도 두지 말아라. 	학교/NNG 가/JKS 마감/NNG 하/XSV 기/ETN 전/NNG 에/JKB 는/JX 집/NNG 에/JKB 돌아오/VV ᆯ/ETM 엄두/NNG 도/JX 두/VV 지/EC 말/VX 어라/EF ./SF
뚱찌두 애니메서 게 무어 습관이 게으르냐?	뚱찌__1/NNG 두/MM 애니/NNP 메/VV 어서/EC 것/NNB 이/JKS 무어/NP 습관/NNG 이/JKS 게으르/VA 냐/EF ?/SF	뚱뚱이도 아니면서 그 뭐 습관이 게으르냐?	뚱뚱이/NNG 도/JX 아니/VCN 면서/EC 그/IC 뭐/IC 습관/NNG 이/JKS 게으르/VA 냐/EF ?/SF
방 안에 사름덜이 자뜩합구마.	방/NNG 안/NNG 에/JKB 사름__2/NNG 덜/XSN 이/JKS 자뜩__1/MAG 합/NNG 구마/EF ./SF	방 안에 사람들이 가득합니다.	방/NNG 안/NNG 에/JKB 사람/NNG 들/XSN 이/JKS 가득/MAG 하/XSA ᆸ니다/EF ./SF
뎌 아바니느 왜조캐 한내 있는 거르 벨라게 좋아한답데.	뎌/NNP 아바니__2/NNG 느/NP 왜조캐/NNG 한내__2/NR 있/VV 는/ETM 거/NNB 르/NNG 벨__9/NNG 라/NNG 이/VCP 게/EC 좋/VA 어/EC 하/VX ᆫ/ETM 답/XSA-I 데/EF ./SF	저 할아버지는 외조카 하나 있는 것을 별나게 좋아한다데.	저/MM 할아버지/NNG 는/JX 외/NNB 조카/NNG 하나/NR 있/VV 는/ETM 것/NNB 을/JKO 별나/VA 게/EC 좋아하/VV ᆫ다/EF 데/NNB ./SF
우리 큰아매느 고사아 많이 해서 일쯕 상새 낫소.	$$$ 우리/NP 큰아매느/NNG 고사/NNG 아/NNG 많이/MAG 하/VV 어서/EC 일/MM 쯕/NNG 상/NNG 새/MM 낫/VA-I 소/EC ./SF	우리 할머니는 고생을 많이 해서 일찍 돌아가셨소.
옛날 영게 우리 촌에 회자 많앳습구마. 	옛날/NNG 영게__1/NP 우리/NP 촌/NNG 에/JKB 회자__5/NNG 많앳습구마/NNG ./SF	옛날 여기 우리 촌에 효자가 많았습니다.	옛날/NNG 여기/NP 우리/NP 촌/NNG 에/JKB 효자/NNG 가/JKS 많/VA 었/EP 습니다/EF ./SF
댜느 내 왜개 쪽 조캐디.	댜느/NNP 내/NNB 왜개__1/NNG 쪽/NNB 조캐__1/NNG 디/EF ./SF	쟤는 내 외가 쪽 조카지.	쟤/NP 는/JX 나/NP 의/JKG 외가/NNG 쪽/NNB 조카/NNG 이/VCP 지/EF ./SF
물고기 대기느 먹댸닣구 짤가 내던딥구마. 	$$$ 물고기/NNG 대기느/NNG 먹댸닣구/NNG 짤/VV ᆯ가/EC 내/VV 던/ETM 딥/NNG 구마/EF ./SF	물고기 대가리는 먹지 않고 잘라서 내던집니다.
훌령한 사람이 데자 하무 핵교서 글으 잘 닑어야 합구마. 	$$$ 훌/NNP 령/NNG 한/MM 사람/NNG 이/JKS 데자/NNP 하무/NNG 핵교/NNG 서/JKB 글/NNG 으/JKG 잘/MAG 닑어야/NNG 합/NNG 구마/EF ./SF	훌륭한 사람이 되자 하면 학교에서 공부를 잘해야 합니다.
돌호박에다 찰옥수꾸 넣구 물으 줘서 누무디.	돌/NNG 호박/NNG 에다/JKB 찰옥수꾸/NNG 넣/VV 구/EC 물/NNG 으/JKG 주/VV 어서/EC 누무__1/VV 디/EF ./SF	돌확에다 찰옥수수를 넣고 물을 주어서 능그지.	돌확/NNG 에다/JKB 차/VA ᆯ/ETM 옥수수/NNG 를/JKO 넣/VV 고/EC 물/NNG 을/JKO 주/VV 어서/EC 능/NNG 그/VA 지/EF ./SF
나르 찻아오는 사람이사 많으무 둏습지. 	나/NP 르/NNG 찻아오__1/VV 는/ETM 사람/NNG 이사/NNG 많으무/NNP 둏__1/VA 습지/NNG ./SF	나를 찾아오는 사람이야 많으면 좋지요. 	나/NP 를/JKO 찾아오/VV 는/ETM 사람/NNG 이야/JX 많/VA 으면/EC 좋/VA 지요/EF ./SF
초오 쏴서 사냐아 하기두 하구 하리살루두 사냐아 햇습구마. 	초오/NNG 쏘/VV 어서/EC 사냐아/NNG 하/VV 기/ETN 두/JX 하/VX 구/EC 하리살__1/NNG 루두/NNG 사냐아/NNG 하/XSV 엇/EP 습/NNG 구마/EF ./SF	총을 쏴서 사냥을 하기도 하고 화살로도 사냥을 했습니다.	총/NNG 을/JKO 쏘/VV 어서/EC 사냥/NNG 을/JKO 하/VV 기/ETN 도/JX 하/VX 고/EC 화살/NNG 로/JKB 도/JX 사냥/NNG 을/JKO 하/VV 었/EP 습니다/EF ./SF
옛날에사 큰질에 가무 차군덜이 많앳지. 즈끔은 한나투 없소.	옛날/NNG 에/JKB 사/JX 큰질__1/NNG 에/JKB 가무/NNG 차/NNG 군/NNG 덜/XSN 이/JKS 많앳지/NNG ./SF 즈끔/NNG 은/JX 한나__2/NR 투/NR 없/VA 소/EC ./SF	옛날에야 큰길에 가면 차꾼들이 많았지. 지금은 하나도 없소.	옛날/NNG 에/JKB 야/JX 큰길/NNG 에/JKB 가/VV 면/EC 차/NNG 꾼/XSN 들/XSN 이/JKS 많/VA 었/EP 지/EF ./SF 지금/NNG 은/JX 하나/NR 도/JX 없/VA 소/EC ./SF
넷날에느 옷짓으 다리자 하무 윤뒤르 썻습구마.	넷날에느/NNP 옷/NNG 짓/VV-I 으/JKG 다리/VV 자/EC 하무/NNG 윤뒤__1/NNG 르/NNG 썻습구마/NNG ./SF	옛날에는 옷깃을 다리자 하면 인두를 썼습니다.	옛날/NNG 에/JKB 는/JX 옷깃/NNG 을/JKO 다리/VV 자/EC 하/VV 면/EC 인두/NNG 를/JKO 쓰/VV 었/EP 습니다/EF ./SF
깔으 뻬자구 하무 낫이 잇어야 합지. 	깔__3/NNG 으/JKG 뻬__1/VV 자구/EC 하/VV 무/NNG 낫/NNG 이/JKS 잇/VX-R 어야/EC 합/NNG 지/EF ./SF	꼴을 베자고 하면 낫이 있어야 하지요. 	꼴/NNG 을/JKO 베/VV 자고/EC 하/VV 면/EC 낫/NNG 이/JKS 있/VV 어야/EC 하/VX 지요/EF ./SF
니발소에서 일하는 사름으 니발재라구 하지 무슨 딴 말이 잇슴둥?	니발__1/NNG 소/NNG 에서/JKB 일/NNG 하/XSV 는/ETM 사름__2/NNG 으/JKG 니발재__1/NNG 이/VCP 라구/EC 하/VV 지/EC 무슨/MM 딴/MM 말/NNG 이/JKS 잇/NNG 스/VV ᆷ/EC 둥/NNB ?/SF	이발소에서 일하는 사람을 이발사라고 하지 무슨 딴 말이 있습니까?	이발소/NNG 에서/JKB 일/NNG 하/XSV 는/ETM 사람/NNG 을/JKO 이발사/NNG 이/VCP 라고/EC 하/VV 지/EC 무슨/MM 딴/MM 말/NNG 이/JKS 있/VV 습니까/EF ?/SF
이쎄 싸온 달갈이 굵닷하구 둏습구마. 	이쎄__1/NNG 싸__21/VV 오/VX ᆫ/ETM 달갈__1/NNG 이/JKS 굵닷하__1/VA-I 구/EC 둏__1/VA 습/NNG 구마/EF ./SF	요사이 사온 달걀이 굵다랗구 좋습니다. 	요사이/NNG 사/VV 어/EC 오/VV ᆫ/ETM 달걀/NNG 이/JKS 굵다랗/VA-I 구/EC 좋/VA 습니다/EF ./SF
서쪽서 부는 바름우 하느바름이라 하오.	서쪽/NNG 서/NNG 부/NNG 는/JX 바르/VA ᆷ/ETN 우/NNG 하느바름__1/NNG 이/VCP 라/EC 하/VV 오/EF ./SF	서쪽에서 부는 바람을 하늬바람이라 하오.	서쪽/NNG 에서/JKB 불/VV 는/ETM 바람/NNG 을/JKO 하늬바람/NNG 이/VCP 라/EC 하/VV 오/EF ./SF
아덜이 더럽은 흙으 만지구 그러무 제뿌리라구 말합구마. 	아__23/NNG 덜/XSN 이/JKS 더럽/VA-I 은/ETM 흙/NNG 으/JKG 만지/VV 구/EC 그러/VV 어/EF 무/NNG 제뿌리__1/VV 라구/EF 말/NNG 합/NNG 구마/EF ./SF	아이들이 더러운 흙을 만지고 그러면 집어던지라고 말합니다. 	아이/NNG 들/XSN 이/JKS 더럽/VA-I 은/ETM 흙/NNG 을/JKO 만지/VV 고/EC 그러/VV 면/EC 집어던지/VV 라고/EC 말/NNG 하/XSV ᆸ니다/EF ./SF
나두 그른 거 밨슴다.	나/NP 두/JX 그른__1/MM 거/NNB 밨/NNG 슴다/EF ./SF	나도 그런 거 봤습니다.	나/NP 도/JX 그런/MM 거/NNB 보/VV 었/EP 습니다/EF ./SF
칩운데 두루박 닙구 가거라.	칩운데/NNG 두루박__1/NNG 닙구/NNG 가/VV 거라/EF ./SF	추운데 두루마기 입고 가거라.	춥/VA-I 은데/EC 두루마기/NNG 입/VV-R 고/EC 가/VV 거라/EF ./SF
재래지느 닢사기 긑이 동굴싸한 것두 잇구 뾰죽스레한 것두 잇습구마.	재래지느/NNG 닢사기__1/NNG 긑이/NNG 동굴/NNG 싸하/VA ᆫ/ETM 것/NNB 두/JX 잇/VV-I 구/EC 뾰죽/MAG 스레/XSM 하/VV ᆫ/ETM 것/NNB 두/JX 잇/VV-I 습/NNG 구마/EF ./SF	굴참나무는 잎사귀 끝이 동그스름한 것도 있고 뾰족한 것도 있습니다.	굴참나무/NNG 는/JX 잎사귀/NNG 끝/NNG 이/JKS 동그스름/XR 하/XSA ᆫ/ETM 것/NNB 도/JX 있/VA 고/EC 뾰족/MAG 하/XSA ᆫ/ETM 것/NNB 도/JX 있/VV 습니다/EF ./SF
지내 바쁘다 나니 일꾼덜이 다 다망햇습구마. 	지내/VV 어/EC 바쁘/VA 다/EC 나/VX 니/EC 일/NNG 꾼/XSN 덜/XSN 이/JKS 다/MAG 다/MAG 망하/VV 엇/EP 습/NNG 구마/EF ./SF	너무 힘들다 보니 일꾼들이 다 도망했습니다. 	너무/MAG 힘들/VA 다/EC 보/VX 니/EC 일/NNG 꾼/XSN 들/XSN 이/JKS 다/MAG 도망/NNG 하/XSV 었/EP 습니다/EF ./SF
강태 낀 돌으느 미끌미끌하대님둥?	$$$ 강/NNG 태/NNG 끼/VV ᆫ/ETM 돌으느/NNG 미끌미끌/MAG 하/XSA 대/EF 님/XSN 둥/MAG ?/SF	이끼 낀 돌은 미끌미끌하지 않습니까?
우리 집에서느 제새르 달마당 기냅구마. 	우리/NP 집/NNG 에서/JKB 느/NP 제새__1/NNG 르/NNG 달/NNG 마당/NNG 기냅구마/NNG ./SF	우리 집에서는 제사를 달마다 지냅니다. 	우리/NP 집/NNG 에서/JKB 는/JX 제사/NNG 를/JKO 달/NNG 마다/JX 지내/VV ᆸ니다/EF ./SF
부시짗으 개져 와서 부시돌에 가차이 대오.	부시짗__1/NNG 으/JKG 개/NNG 지/VV 어/EC 오/VX 어서/EC 부시/NNP 돌/NNG 에/JKB 가차/NNG 이/NR 대/NNB 오/NR ./SF	부싯깃을 가져 와서 부싯돌에 가까이 대오.	부/NNG 싯/NNG 깃/NNG 을/JKO 가지/VV 어/EC 오/VX 어서/EC 부싯돌/NNG 에/JKB 가까이/MAG 대/VV 오/EF ./SF
서답갠으르 가서 네 어마이르 모시구 오나라. 	서답갠__1/NNG 으르/VV 가/VV 어서/EC 너/NP 의/JKG 어마이__2/NNG 르/NNG 모시/VV 구/EC 오나라/NNP ./SF	빨래터로 가서 네 어머니를 모시고 오너라. 	빨래터/NNG 로/JKB 가/VV 어서/EC 너/NP 의/JKG 어머니/NNG 를/JKO 모시/VV 고/EC 오/VV 너라/EF ./SF
그 사름이 일이 바쁘다 나니 얼푸덩 집으르 달아낫습구마. 	그/MM 사름__2/NNG 이/JKS 일/NNG 이/JKS 바쁘__7/VA-I 다/EC 나/VX 니/EC 얼푸덩__1/MAG 집으르/NNG 달아나/VV 엇/EP 습/NNG 구마/EF ./SF	그 사람이 일이 어렵다 보니 얼른 집으로 달아났습니다. 	그/MM 사람/NNG 이/JKS 일/NNG 이/JKS 어렵/VA-I 다/EC 보/VX 니/EC 얼른/MAG 집/NNG 으로/JKB 달아나/VV 었/EP 습니다/EF ./SF
가스집에서 묵구 갓습메?	가스집__2/NNG 에서/JKB 묵/VV 구/EC 가/VV 엇/EP 습/NNG 메/NNG ?/SF	처갓집에서 묵고 갔는가?	처갓집/NNG 에서/JKB 묵/VV 고/EC 가/VX 었/EP 는가/EF ?/SF
아매가 내 한께 이붓집에 가서 저낙으 먹구 왓습지.	아매__1/NNG 가/JKS 나/NP 의/JKG 한께__1/MAG 이/MM 붓/NNG 집/NNG 에/JKB 가/VV 어서/EC 저낙__1/NNG 으/NNG 먹/VV 구/EC 오/VV 엇/EP 습지/NNG ./SF	할머니와 내가 함께 이웃집에 가서 저녁을 먹고 왔지요.	할머니/NNG 와/JC 나/NP 가/JKS 함께/MAG 이웃집/NNG 에/JKB 가/VV 어서/EC 저녁/NNG 을/JKO 먹/VV 고/EC 오/VV 었/EP 지요/EF ./SF
내 어레실 적에 어시덜가 헤디다 나니 많이 울엇습구마. 	나/NP 의/JKG 어레/NNG 이/VCP 시/EP ᆯ/ETM 적/NNB 에/JKB 어시덜/NNG 가/JKS 헤디__1/VV 다/EC 나/VX 니/EC 많이/MAG 울/VV 엇/EP 습/NNG 구마/EF ./SF	내가 어렸을 적에 부모들과 헤지다 보니 많이 울었습니다. 	나/NP 가/JKS 어리/VA 었/EP 을/ETM 적/NNB 에/JKB 부모/NNG 들/XSN 과/JC 헤지/VV 다/EC 보/VX 니/EC 많이/MAG 울/VV 었/EP 습니다/EF ./SF
나느 대떨이르 보두 못햇습구마.	나느/NNG 대떨이__1/NNG 르/NNG 보/NNG 두/JX 못/MAG 하/VV 엇/EP 습/NNG 구마/EF ./SF	나는 재떨이를 보지도 못했습니다.	나/NP 는/JX 재떨이/NNG 를/JKO 보/VV 지/EC 도/JX 못/MAG 하/VV 었/EP 습니다/EF ./SF
내 거르망이에 돈을 옇엇수다. 	나/NP 의/JKG 거르망이__1/NNG 에/JKB 돈/NNG 을/JKO 옇__1/VV 엇/EP 수다/EF ./SF	내가 호주머니에 돈을 넣었습니다. 	나/NP 가/JKS 호주머니/NNG 에/JKB 돈/NNG 을/JKO 넣/VV 었/EP 습니다/EF ./SF
산에 낭기 많이 싱거서 보기 둏습구마. 	산/NNG 에/JKB 낭기__1/NNG 많이/MAG 싱거서/NNG 보/VV 기/ETN 둏__1/VA 습/NNG 구마/EF ./SF	산에 나무 많이 심어서 보기 좋습니다.	산/NNG 에/JKB 나무/NNG 많이/MAG 심/VV 어서/EC 보/VV 기/ETN 좋/VA 습니다/EF ./SF
저낙 먹구 우리 노친이 마스돌이 간다구 나갓습구마.	저낙__1/NNG 먹/VV 구/EC 우리/NP 노친/NNG 이/JKS 마스돌이__1/NNG 가/VV ᆫ다구/EC 나가/VV 엇/EP 습/NNG 구마/EF ./SF	저녁 먹고 우리 노친이 마을돌이 간다고 나갔습니다.	저녁/NNG 먹/VV 고/EC 우리/NP 노친/NNG 이/JKS 마을/NNG 돌/NNG 이/JKS 가/VV ᆫ다고/EC 나가/VV 었/EP 습니다/EF ./SF
달개 잇는 날에느 어른아덜이 무섭아 집으루 달아가지.	달개__7/NNG 잇/VV-I 는/ETM 날/NNG 에/JKB 느/NP 어른/NNG 아/NNG 덜/XSN 이/JKS 무섭/VA-I 아/JKV 집/NNG 으루/JKB 달아가__1/VV 지/EF ./SF	월식이 있는 날에는 어린아이들이 무서워 집으로 달려가지.	월식/NNG 이/JKS 있/VV 는/ETM 날/NNG 에/JKB 는/JX 어린아이/NNG 들/XSN 이/JKS 무섭/VA-I 어/EC 집/NNG 으로/JKB 달려가/VV 지/EF ./SF
호분자 부그럽아서 양지가 쉬떡터르 됐지.	호분자__1/NNG 부그럽아서/NNG 양지__2/NNG 가/VV 쉬떡__1/NNG 터르/NNG 되/VV 었/EP 지/EF ./SF	혼자 부끄러워서 얼굴이 수수떡처럼 됐지.	혼자/NNG 부끄럽/VA-I 어서/EC 얼굴/NNG 이/JKS 수수떡/NNG 처럼/JKB 되/VV 었/EP 지/EF ./SF
저낙때 댓으니까데 얼핑 집으르 가서 밥하구 장물으 끓에 아덜으 멕에야 합구마. 	저낙때__1/NNG 대/VV 엇/EP 으니까/EC 데/NNB 얼핑__1/MAG 집으르/NNG 가/VV 어서/EC 밥/NNG 하구/JC 장물__9/NNG 으/NNG 끓/VV 에/JKB 아__23/NNG 덜/XSN 으/JKG 멕에야/NNG 합/NNG 구마/EF ./SF	저녁때가 되었으니까 얼른 집으로 가서 밥하고 장국을 끓여 아이들을 먹여야 합니다.	저녁/NNG 때/NNG 가/JKC 되/VV 었/EP 으니까/EC 얼른/MAG 집/NNG 으로/JKB 가/VV 어서/EC 밥/NNG 하/XSV 고/EC 장국/NNG 을/JKO 끓이/VV 어/EC 아이/NNG 들/XSN 을/JKO 먹이/VV 어야/EC 하/VX ᆸ니다/EF ./SF
밥우 처 빨리 먹다 나니 얹이웟습구마. 	밥/NNG 우/NNG 처__11/MAG 빨리/MAG 먹/VV 다/EC 나/VX 니/EC 얹이웟습구마/NNG ./SF	밥을 너무 빨리 먹다 보니 얹혔습니다. 	밥/NNG 을/JKO 너무/MAG 빨리/MAG 먹/VV 다/EC 보/VX 니/EC 얹히/VV 었/EP 습니다/EF ./SF
이 약이 회레기 없다 나이 통세 아이 없어지오. 	이/MM 약/NNG 이/JKS 회레기__1/NNG 없/VA 다/EF 나이/NNG 통/NNG 세/MM 아이/NNG 없어지/VV 오/EF ./SF	이 약이 효력이 없다 보니 통세가 없어지지 않소.	이/MM 약/NNG 이/JKS 효력/NNG 이/JKS 없/VA 다/EC 보/VX 니/EC 통/MAG 세/NNG 가/JKS 없/VA 어/EC 지/VX 지/EC 않/VX 소/EC ./SF
들에 가무 메때기 맹깁구마.	들/NNG 에/JKB 가/VV 어/EC 무/NNG 메때기/NNG 맹깁구마/NNG ./SF	들에 가면 메뚜기가 많습니다.	들/NNG 에/JKB 가/VV 면/EC 메뚜기/NNG 가/JKS 많/VA 습니다/EF ./SF
사름우 함벌루 박대르 하구 그러무 아이 됩지.	사름__2/NNG 우/JKG 함벌루__1/MAG 박대/NNG 르/NNG 하/VV 구/EC 그러/VV 어/EF 무/XPN 아이/NNG 됩지/NNG ./SF	사람을 함부로 박대를 하고 그러면 안 되지요.	사람/NNG 을/JKO 함부로/MAG 박대/NNG 를/JKO 하/VV 고/EC 그러/VV 면/EC 안/MAG 되/VV 지요/EF ./SF
아즈바니, 집우 가기오.	아즈바니__1/NNG ,/SP 집/NNG 우/NNG 가/VV 기/ETN 이/VCP 오/EF ./SF	작은아버지, 집에 갑시다.	작은아버지/NNG ,/SP 집/NNG 에/JKB 가/VV ᆸ시다/EF ./SF
몽노에 토끼 다리 걸겠다.	몽노__1/NNG 에/JKB 토끼/NNG 다리/NNG 걸/VV 겠/EP 다/EF ./SF	올가미에 토끼 다리가 걸렸다.	올가미/NNG 에/JKB 토끼/NNG 다리/NNG 가/JKS 걸리/VV 었/EP 다/EF ./SF
강에서 헤임 잘못 치무 큰일 납구마. 	강/NNG 에서/JKB 헤임__2/NNG 잘/MAG 못/MAG 하/VV 지/EF 무/XPN 큰일/NNG 납/NNG 구마/EF ./SF	강에서 헤엄 잘못 치면 큰일 납니다. 	강/NNG 에서/JKB 헤엄/NNG 잘못/MAG 치/VV 면/EC 큰일/NNG 나/VV ᆸ니다/EF ./SF
우리 아매 세에 세바눌이 돋아서 밥두 먹지 못하구 잇으니 내 맴이 좋댸넷습구마. 	$$$ 우리/NP 아매/MAG 세/NNB 에/JKB 세바/NNP 눌/VV 이/JKS 돋/VV-R 어서/EC 밥/NNG 두/JX 먹/VV 지/EC 못하/VX 구/EC 잇/VX-R 으니/EC 나/NP 의/JKG 맴/NNG 이/JKS 좋댸넷습구마/NNG ./SF	우리 할머니가 혀에 혓바늘이 돋아서 밥도 먹지 못하고 있으니 내 마음이 좋지 않았습니다. 
떡으 네 사름 나시마 더 많이 싸 왓습구마. 	떡/NNG 으/JKG 네/MM 사름__2/NNG 나시__7/NNG 마/MAG 더/MAG 많이/MAG 싸__21/VV 오/VV 엇/EP 습/NNG 구마/EF ./SF	떡을 네 사람 몫보다 더 많이 사 왔습니다. 	떡/NNG 을/JKO 네/MM 사람/NNG 몫/NNG 보다/JKB 더/MAG 많이/MAG 사/VV 어/EC 오/VV 었/EP 습니다/EF ./SF
저 사름으느 벡새 많습구마. 	저/MM 사름__2/NNG 으느/NNG 벡새__1/NNG 많/VA 습/NNG 구마/EF ./SF	저 사람은 질투가 많습니다. 	저/MM 사람/NNG 은/JX 질투/NNG 가/JKS 많/VA 습니다/EF ./SF
오늘으느 내 한전밭에 나가 우버이르 캐 오갯습구마.	오늘으느/NNP 내/NNB 한전/NNP 밭/NNG 에/JKB 나가/VV 어/EC 우버이__1/NNG 르/NNG 캐/VV 오갯습구마/NNG ./SF	오늘은 내가 밭에 나가 우엉을 캐 오겠습니다.	오늘/NNG 은/JX 나/NP 가/JKS 밭/NNG 에/JKB 나가/VV 어/EC 우엉/NNP 을/JKO 캐/VV 어/EC 오/VX 겠/EP 습니다/EF ./SF
영게 슈끼 과연 맛이 잇습구마.	영게__1/NP 슈끼__1/NNG 과연/MAG 맛/NNG 이/JKS 잇/VV-I 습/NNG 구마/EF ./SF	여기 옥수수가 정말 맛이 있습니다.	여기/NP 옥수수/NNG 가/JKS 정말/MAG 맛/NNG 이/JKS 있/VV 습니다/EF ./SF
그 짓 왜지느 완으르 닉대냇어두 색깔으느 빨갛더라.	$$$ 그/MM 짓/NNG 왜지느/NNG 완으르/NNG 닉대냇어두/NNG 색깔으느/NNG 빨갛/VA-I 더라/EF ./SF	그 집 자두는 완전히 익지 않았어도 색깔은 빨갛더라.
옛날에느 어찌나 구차한지 쌀독이 항상 골아 잇엇습구마. 	옛날/NNG 에/JKB 느/NP 어찌나/MAG 구차/NNG 하/XSA ᆫ지/EC 쌀/NNG 독/NNG 이/JKS 항상/MAG 골__3/VV 아/NNG 잇/NNG 엇/EP 습/NNG 구마/EF ./SF	옛날에는 어찌나 구차한지 쌀독이 항상 비어 있었습니다. 	옛날/NNG 에/JKB 는/JX 어찌나/MAG 구차/NNG 하/XSA ᆫ지/EC 쌀/NNG 독/NNG 이/JKS 항상/MAG 비/VV 어/EC 있/VX 었/EP 습니다/EF ./SF
용말그 올레야 집이 다 됐다구 한단 말이오.	용/NNG 말/NNG 그/MM 올레/NNP 야/JKV 집/NNG 이/JKS 다/MAG 되/VV 었/EP 다구/EC 하/VV ᆫ단/ETM 말/NNG 이/VCP 오/EF ./SF	용마루를 올려야 집이 다 됐다고 한단 말이오.	용마루/NNG 를/JKO 올리/VV 어야/EC 집/NNG 이/JKS 다/MAG 되/VV 었/EP 다고/EC 하/VV ᆫ단/ETM 말/NNG 이/VCP 오/EF ./SF
돈으 히푸기 쓰지 말라구 내 어시덜이 자주루 말햇수다. 	돈/NNG 으/JKG 히푸__1/VA 기/ETN 쓰/VV 지/EC 말/VX 라구/EC 나/NP 의/JKG 어시덜/NNG 이/VCP 자/EC 주루/NNG 말/NNG 하/XSV 엇/EP 수다/EF ./SF	돈을 헤프게 쓰지 말라고 내 부모들이 자주 말했습니다. 	돈/NNG 을/JKO 헤프/VA 게/EC 쓰/VV 지/EC 말/VX 라고/EC 나/NP 의/JKG 부모/NNG 들/XSN 이/JKS 자주/MAG 말/NNG 하/XSV 었/EP 습니다/EF ./SF
다부지를 베다가 모태불으 피우자.	다부지__1/NNG 를/JKO 베/VV 어다가/EC 모태불__1/NNG 으/NNG 피우/VV 자/EF ./SF	풀을 베다가 모닥불을 피우자.	풀/NNG 을/JKO 베/VV 어다가/EC 모닥불/NNG 을/JKO 피우/VV 자/EF ./SF
낯이 곱은 새애기르 더부레와서 우리 어시덜이 둏아햇습구마. 	낯/NNG 이/JKS 곱/VA-I 은/ETM 새애기__2/NNG 르/NNG 더/MAG 부레/NNG 오/VV 어서/EC 우리/NP 어시__1/NNG 덜/XSN 이/JKS 둏__1/VA 어/EC 하/VX 엇/EP 습/NNG 구마/EF ./SF	낯이 고운 새색시를 데려와서 우리 어버이들이 좋아했습니다. 	낯/NNG 이/JKS 곱/VA-I 은/ETM 새색시/NNG 를/JKO 데려오/VV 어서/EC 우리/NP 어버이/NNG 들/XSN 이/JKS 좋아하/VV 었/EP 습니다/EF ./SF
내게 아들이 한내 잇습구마.	나/NP 에게/JKB 아들/NNG 이/JKS 한내__2/NR 잇/VV-I 습/NNG 구마/EF ./SF	나에게 아들이 하나 있습니다.	나/NP 에게/JKB 아들/NNG 이/JKS 하나/NR 있/VA 습니다/EF ./SF
넷날에사 먹을 것두 벤벤히 못 먹구 살았는데 무스거 돈을르 새 닙성 해 닙엇갯소?	넷/NR 날/NNG 에/JKB 사/VV 어/EC 먹/VV 을/ETM 것/NNB 두/MM 베/VV ᆫ/ETM 베/VV ᆫ/ETM 히/XSM 못/MAG 먹/VV 구/EC 살/VV 었/EP 는데/EC 무스/NNG 거/NNB 돈/NNG 을/JKO 르/NNG 새/MM 닙성__1/NNG 하/XSV 어/EC 닙엇갯소/NNG ?/SF	옛날에야 먹을 것도 변변히 못 먹고 살았는데 무슨 돈으로 새 입성 해 입었겠소?	옛날/NNG 에/JKB 야/JX 먹/VV 을/ETM 것/NNB 도/JX 변변히/MAG 못/MAG 먹/VV 고/EC 살/VV 었/EP 는데/EC 무슨/MM 돈/NNG 으로/JKB 새/MM 입성/NNG 하/XSV 어/EC 입/VV-R 었/EP 겠/EP 소/EC ?/SF
가스어마니, 댱마다으 같이 가디 않갰슴두?	가스어마니__1/NNG ,/SP 댱마다으/NNG 같이/MAG 가/VV 디/EC 않갰슴두/NNG ?/SF	가시어머니, 장에 같이 가지 않겠습니까?	가/VV 시어머니/NNG ,/SP 장/NNG 에/JKB 같이/MAG 가/VV 지/EC 않/VX 겠/EP 습니까/EF ?/SF
시원한 샘칫물으 마시무 기분이 둏습구마. 	시원/XR 하/XSA ᆫ/ETM 샘칫물__1/NNG 으/JKG 마시/VV 무/NNG 기분/NNG 이/JKS 둏__1/VA 습/NNG 구마/EF ./SF	시원한 샘물을 마시면 기분이 좋습니다. 	시원/XR 하/XSA ᆫ/ETM 샘물/NNG 을/JKO 마시/VV 면/EC 기분/NNG 이/JKS 좋/VA 습니다/EF ./SF
새애기는 사름이 그렇듯합구마.	새애기__2/NNG 는/JX 사름__2/NNG 이/JKS 그렇/VA-I 듯/EC 합/NNG 구마/EF ./SF	새색시는 사람이 무던합니다.	새색시/NNG 는/JX 사람/NNG 이/JKS 무던/XR 하/XSA ᆸ니다/EF ./SF
낼으느 장마다에 가서 우티감우 좀 싸 오나라.	낼으느/NNG 장/NNB 마다/JX 에/JKB 가/VV 어서/EC 우티감__1/NNG 우/NNG 좀/MAG 싸__21/VV 오나라/NNP ./SF	내일은 장에 가서 옷감을 좀 사 오너라.	내일/NNG 은/JX 장/NNG 에/JKB 가/VV 어서/EC 옷감/NNG 을/JKO 좀/MAG 사/VV 어/EC 오/VV 너라/EF ./SF
젊은이덜으느 손으르 서답질하댸닣구 다 기겔르 합구마. 	$$$ 젊은이/NNG 덜/XSN 으/JKG 느/NP 손으르/NNG 서답질하댸닣구/NNG 다/MAG 기겔르/NNG 합/NNG 구마/EF ./SF	젊은이들은 손으로 빨래하지 않고 다 기계로 합니다. 
내 엊저낙에 오솟길로 왔습메.	나/NP 의/JKG 엊저낙/NNG 에/JKB 오솟길__1/NNG 로/JKB 오/VV 었/EP 습/NNG 메/NNG ./SF	내 엊저녁에 오솔길로 왔네.	나/NP 의/JKG 엊저녁/NNG 에/JKB 오솔길/NNG 로/JKB 오/VV 었/EP 네/EF ./SF
동삼에느 칩우니까데 니불으 잘 아니 덮우무 행불이 옵구마.	동삼에느/NNG 칩우니까데/NNG 니불__1/NNG 으/JKG 잘/MAG 아니/MAG 덮/VV 우/NNG 무/NNG 행/NNG 불/NNG 이/JKS 이/VCP 옵/EP 구마/EF ./SF	겨울에는 추우니까 이불을 잘 덮지 않으면 감기에 걸립니다.	겨울/NNG 에/JKB 는/JX 춥/VA-I 으니까/EC 이불/NNG 을/JKO 잘/MAG 덮/VV 지/EC 않/VX 으면/EC 감기/NNG 에/JKB 걸리/VV ᆸ니다/EF ./SF
동미 자주루 배우지 않구 소식두 끊기와서 내 동미 집에 이정 갓다 왓습구마.	동미__1/NNG 이/VCP 자/EC 주루/NNG 배우__6/VV 지/EC 않/VX 구/EC 소식/NNG 두/JX 끊/VV 기/ETN 오/VV 어서/EC 나/NP 의/JKG 동미__1/NNG 집/NNG 에/JKB 이정__15/MAG 가/VV 엇/EP 다/EC 오/VV 엇/EP 습/NNG 구마/EF ./SF	동무가 자주 보이지 않고 소식도 끊어져서 내가 동무 집에 일부러 갔다 왔습니다.	동무/NNG 가/JKS 자주/MAG 보이/VV 지/EC 않/VX 고/EC 소식/NNG 도/JX 끊어지/VV 어서/EC 나/NP 가/JKS 동무/NNG 집/NNG 에/JKB 일부러/MAG 가/VV 었/EP 다/EC 오/VV 었/EP 습니다/EF ./SF
여드레미 그거 청년덜게서 많이 납구마. 	여드레미__1/NNG 그거/NP 청년/NNG 덜/XSN 것/NNB 이서/JKS 많이/MAG 납/NNG 구마/EF ./SF	여드름 그거 청년들에게서 많이 납니다. 	여드름/NNG 그거/NP 청년/NNG 들/XSN 에게서/JKB 많이/MAG 나/VV ᆸ니다/EF ./SF
배떠리느 오지그릇인데 들기 헐해서 넷날에 가맷전 일할 때 많이 썼디.	$$$ 배떠리느/NNG 오지그릇/NNG 이/VCP ᆫ데/EC 들/VV 기/ETN 헐하/VA 어서/EC 넷/NR 날/NNG 에/JKB 가맷/NNP 전/MM 일/NNG 하/XSV ᆯ/ETM 때/NNG 많이/MAG 쓰/VV 었/EP 디/EF ./SF	자배기는 오지그릇인데 들기 쉬워서 옛날에 부엌일할 때 많이 썼지.
오늘 일은 슬 복잡하구 아니 바쁩구마.	오늘/NNG 일/NNG 은/JX 슬__4/MAG 복잡/XR 하/XSA 구/EF 아니/IC 바쁩구마/NNP ./SF	오늘 일은 덜 복잡하고 어렵지 않습니다.	오늘/NNG 일/NNG 은/JX 덜/MAG 복잡/XR 하/XSA 고/EC 어렵/VA-I 지/EC 않/VX 습니다/EF ./SF
잔내비 무스거 잘 먹는지 내 모릅구마.	잔내비__1/NNG 무스거__1/NP 잘/MAG 먹/VV 는지/EC 나/NP 의/JKG 모릅구마/NNG ./SF	원숭이가 무엇을 잘 먹는지 나는 모릅니다.	원숭이/NNG 가/JKS 무엇/NP 을/JKO 잘/MAG 먹/VV 는지/EC 나/NP 는/JX 모르/VV ᆸ니다/EF ./SF
내 전자아 나가서 죠끈하문 죽을 뻔햇습구마. 	나/NP 의/JKG 전/MM 자아/NNG 나가/VV 어서/EC 죠끈하__1/VV 문/EC 죽/VV 을/ETM 뻔/NNB 하/XSA 엇/EP 습/NNG 구마/EF ./SF	내 전쟁을 나가서 자칫하면 죽을 뻔했습니다. 	나/NP 의/JKG 전쟁/NNG 을/JKO 나가/VV 어서/EC 자칫/MAG 하/XSV 면/EC 죽/VV 을/ETM 뻔/NNB 하/XSA 었/EP 습니다/EF ./SF
아덜이사 무세미르 많이 탑지. 	아__23/NNG 덜/XSN 이사/JX 무세미__2/NNG 르/NNG 많이/MAG 탑지/NNG ./SF	아이들이야 무서움을 많이 타지요. 	아이/NNG 들/XSN 이야/JX 무서움/NNG 을/JKO 많이/MAG 타/VV 지요/EF ./SF
한제 갓다 왓으니까데 발으 씃어라. 	한/NNP 제/MM 가/VV 엇/EP 다/EC 오/VV 엇/EP 으니까/EC 데/NNB 발/NNG 으/NNG 씃__1/VV-R 어라/EF ./SF	한데에 갔다 왔으니까 발을 씻어라. 	한데/MAG 에/JKB 가/VV 었/EP 다/EC 오/VV 었/EP 으니까/EC 발/NNG 을/JKO 씻/VV-R 어라/EF ./SF
오놀으느 조캐 부부 반사비 날이디?	오놀으느/NNG 조캐__1/NNG 부부/NNG 반사비__1/NNG 날/NNG 이/VCP 디/EF ?/SF	오늘은 조카 부부 반살미 날이지?	오늘/NNG 은/JX 조카/NNG 부부/NNG 반/NNG 살/NNB 미/XPN 날/NNG 이/VCP 지/EF ?/SF
아덜이 어즐구구 그러무 깨깢이 치우라구 그럽구마. 	아__23/NNG 덜/XSN 이/JKS 어즐구__1/VV 구/EC 그러/VV 어/EC 무/NNG 깨깢이__1/MAG 치우/VV 라구/EC 그럽구마/NNG ./SF	아이들이 어지르고 그러면 깨끗이 치우라고 그럽니다. 	아이/NNG 들/XSN 이/JKS 어지르/VV 고/EC 그러/VV 면/EC 깨끗이/MAG 치우/VV 라고/EC 그러/VV ᆸ니다/EF ./SF
가시어멈이 멫 살이시쟈?	가시어멈__1/NNG 이/VCP 멫/MM 살/NNB 이/VCP 시/EP 쟈/EF ?/SF	가시어머니가 몇 살이시지?	가/VV 시어머니/NNG 가/JKS 몇/MM 살/NNB 이/VCP 시/EP 지/EF ?/SF
그 모릴래 젠나 왔소.	$$$ 그/MM 모리/VV ᆯ래/EF 젠/NNG 나/JX 오/VV 었/EP 소/EC ./SF	그 말 때문에 일부러 왔소.
내 호불에미 되구 아덜 자래우기 많이 바빴습구마. 	나/NP 의/JKG 호불에미__1/NNG 되/VV 구/EC 아__23/NNG 덜/XSN 자래우__1/VV 기/ETN 많이/MAG 바쁘/VA 었/EP 습/NNG 구마/EF ./SF	내 홀어미가 되고 아이들 기르기가 많이 어려웠습니다. 	나/NP 의/JKG 홀/NNG 어미/NNG 가/JKC 되/VV 고/EC 아이/NNG 들/XSN 기르/VV 기/ETN 가/JKS 많이/MAG 어렵/VA-I 었/EP 습니다/EF ./SF
내 즈끔 아매가 한세 시장에 갑구마.	나/NP 의/JKG 즈끔/NNG 아매__1/NNG 가/JKS 한세__1/MAG 시장/NNG 에/JKB 갑/NNG 구마/EF ./SF	나는 지금 할머니와 함께 시장에 갑니다.	나/NP 는/JX 지금/MAG 할머니/NNG 와/JKB 함께/MAG 시장/NNG 에/JKB 가/VV ᆸ니다/EF ./SF
해우나 시집가서 네 구차하게 살깨 바 어마니느 언제나 오시랍아 하지.	해우나__1/MAG 시집가/VV 어서/EC 너/NP 의/JKG 구차/NNG 하/XSA 게/EC 살/VV 깨/VV 바/NNG 어마니느/NNG 언제나/MAG 오시랍아/NNG 하/VV 지/EF ./SF	행여나 시집가서 네가 구차하게 살까 봐 어머니는 언제나 걱정스러워 하지.	행여나/MAG 시집가/VV 어서/EC 너/NP 가/JKS 구차/NNG 하/XSA 게/EC 살/VV ᆯ까/EC 보/VX 어/EC 어머니/NNG 는/JX 언제나/MAG 걱정/NNG 스럽/XSA-I 어/EC 하/VX 지/EF ./SF
내 동미 간댈사 나르 얼리구 갓갯슴두?	나/NP 의/JKG 동미__1/NNG 간댈사__1/MAG 나/NP 르/NNG 얼리__9/VV 구/EC 갓갯슴두/NNG ?/SF	내 동무가 설마 나를 속이고 갔겠습니까?	나/NP 의/JKG 동무/NNG 가/JKS 설마/MAG 나/NP 를/JKO 속이/VV 고/EC 가/VV 었/EP 겠/EP 습니까/EF ?/SF
나는 핵교에셔 집으르 혼소발 갔다.	나/NP 는/JX 핵교__1/NNG 에/JKB 시/VA 어/EC 집으르/NNG 혼소발__1/MAG 가/VX 었/EP 다/EF ./SF	나는 학교에서 집으로 곧바로 갔다.	나/NP 는/JX 학교/NNG 에서/JKB 집/NNG 으로/JKB 곧바로/MAG 가/VV 었/EP 다/EF ./SF
어전 자석덜이 집에 자주루 오댸닣구 따따금 오오.	$$$ 어/IC 전/MM 자석/NNG 덜/XSN 이/JKS 집/NNG 에/JKB 자주/MAG 루/JKB 오댸닣구/NNG 따따/NNP 금/NNG 오오/IC ./SF	이제는 자식들이 집에 자주 오지 않고 이따금 오오.
