길이 개패로우니 노냥 올라가라야.	길/NNG 이/JKS 개패롭__1/VA-I 으니/EC 노냥__2/MAG 올라가/VV 어라야/EF./SF	길이 가파르니 천천히 올라가라.
쌀이 없어서나리 쌀쉬수루 죽얼 낋였다.	쌀/NNG 이/JKS 없/VA 어서나리/EC 쌀쉬수__1/NNG 루/JKB 죽/NNG 얼/JKO 낋이__1/VV 었/EP 다/EF ./SF	쌀이 없어서 쌀수수로 죽을 끓였다.
당신 돈얼 흐프게 쓰지 마시라오.	당신/NP 돈/NNG 얼/JKO 흐프__1/VA 게/EC 쓰/VV 지/EC 말/VX 시/EP 라오/EF ./SF	당신 돈을 헤프게 쓰지 마시오.
그 아는 세날 꿈꾸막스럽다.	그/MM 아__23/NNG 는/JX 세날__1/NNG 꿈꾸막스럽__1/VA-I 다/EF ./SF	그 아이는 조금 엉뚱스럽다.
아덜이 할마께 쉰사 드린다.	아/NNG 덜/XSN 이/JKS 할마__1/NNG 께/JKB 쉰사/XR 드리/VV ᆫ다/EF ./SF	아이들이 할머니께 수인사 드린다.
뒤꺼럽던 밖이 쌸 조용해졌다.	뒤꺼럽__1/VA-I 던/ETM 밖/NNG 이/JKS 쌸__2/MAG 조용/XR 하/XSA 어/EC 지/VX 었/EP 다/EF ./SF	시끄럽던 밖이 조금 조용해졌다.
몬지가 바람에 날아갔다.	몬지__1/NNG 가/JKS 바람/NNG 에/JKB 날아가/VV 었/EP 다/EF ./SF	먼지가 바람에 날아갔다.
쥐럴 잡으려구 방마당 쥐창애럴 놓았다.	쥐/VV 럴/JKO 잡/VV-R 으려구/EC 방/NNG 마당/JX 쥐창애__1/NNG 럴/JKO 놓/VV 었/EP 다/EF ./SF	쥐를 잡으려고 방마다 쥐덫을 놓았다.
쌍두이라 닮았다.	쌍두이__1/NNG 이/VCP 라/EC 닮/VV 었/EP 다/EF ./SF	쌍둥이라 닮았다.
우티 꼬매 줄게 바너질당지 가졔오나라.	우티__1/NNG 꼬매__1/VV 어/EC 주/VX ᆯ게/EF 바너질당지__1/NNG 가지/VV 어/EC 오/VX 나라/EF ./SF	옷 꿰매 줄게 바느질고리 가져오너라.
날이 풀렸으니까니 가럼우티 한 벌 사 주라요.	날/NNG 이/JKS 풀리/VV 었/EP 으니까니/EC 가럼우티__1/NNG 한/MM 벌/NNB 사/VV 어/EC 주/VX 라요/EF ./SF	날이 풀렸으니까 나들이옷 한 벌 사 줘요.
오마이는 즘생얼 집이 들이는 것얼 진한한다.	오마이__1/NNG 는/JX 즘생__1/NNG 얼/JKO 집/NNG 이/JKB 들이/VV 는/ETM 것/NNB 얼/JKO 진한하__2/VV ᆫ다/EF ./SF	어머니는 짐승을 집에 들이는 것을 싫어한다.
그 집으느 오래됐으니깨니 지두가 성치 않은 것이우.	그/MM 집/NNG 으느/JX 오래/MAG 되/VV 었/EP 으니깨니/EC 지두__5/NNG 가/JKS 성/NNG 하/XSV 지/EC 않/VX 은/ETM 것/NNB 이/VCP 우/EF ./SF	그 집은 오래됐으니까 기둥이 성치 않은 것이오.
아덜이 뒤꺼럽게 과서 혼달궜다.	아__23/NNG 덜/XSN 이/JKS 뒤꺼럽__1/VA-I 게/EC 고__5/VV 어서/EC 혼달구__1/VV 었/EP 다/EF ./SF	아이들이 시끄럽게 떠들어서 혼냈다.
오마니는 온할레 벜이서 일하곤 했수다레.	오마니__1/NNG 는/JX 온할레__1/NNG 벜__2/NNG 이서/JKB 일/NNG 하/XSV 곤/EC 하/VX 었/EP 수다레/EF ./SF	어머니는 온종일 부엌에서 일하곤 했습니다.
고구마를 따설라무니 대리찌에다 담는다.	고구마/NNG 를/JKO 따/VV 어서/EC ᆯ라무니/EC 대리찌__1/NNG 에다/JKB 담/VV 는다/EF ./SF	고구마를 따서 다래끼에다 담는다.
물이 차거우니 다구운 물얼 더 부어라.	물/NNG 이/JKS 차겁/VA-I 으니/EC 다굽/VA-I 은/ETM 물/NNG 얼/JKO 더/MAG 붓/VV-I 어라/EF ./SF	물이 차가우니 뜨거운 물을 더 부어라.
갑재기 무루가 쏟아져 복숭애가 다 떨어졌습니다레.	갑재기/MAG 무루__8/NNG 가/JKS 쏟아지/VV 어/EC 복숭애__1/NNG 가/JKS 다/MAG 떨어지/VV 었/EP 습니다레/EF ./SF	갑자기 우박이 쏟아져 복숭아가 다 떨어졌습니다.
그는 혐이 쉽기 합격했다.	그/NP 는/JX 혐__1/NNG 이/JKB 쉽/VA-I 기/EC 합격/NNG 하/XSV 었/EP 다/EF ./SF	그는 시험에 쉽게 합격했다.
성이 내 돈얼 뚜꺼먹고 주지럴 않는다.	성__5/NNG 이/JKS 나/NP 의/JKG 돈/NNG 얼/JKO 뚜꺼먹__2/VV 고/EC 주/VV 지/EC 럴/JKO 않/VX 는다/EF ./SF	형이 내 돈을 떼어먹고 주지를 않는다.
얘야, 새질거리지 말구 얌전히 있어라야.	얘/NP 야/JKV ,/SP 새질거리__1/VV 지/EC 말/VX 구/EC 얌전히/MAG 있/VV 어라야/EF ./SF	얘야, 새실거리지 말고 얌전히 있어라.
저번에 싱군 밤에 더금잎이 났다.	저번/NNG 에/JKB 싱구__1/VV ᆫ/ETM 밤/NNG 에/JKB 더금잎__1/NNG 이/JKS 나/VV 었/EP 다/EF ./SF	저번에 심은 밤에 떡잎이 났다.
핵교 끝나무 꼬장 오나라.	핵교/NNG 끝나/VV 무/EC 꼬장__3/MAG 오/VV 나라/EF ./SF	학교 끝나면 곧장 오너라.
동상이 성버담 더 키두 크구 머굽다.	동상__1/NNG 이/JKS 성__5/NNG 버담/JKB 더/MAG 키/NNG 두/JX 크/VA 구/EC 머굽__1/VA-I 다/EF ./SF	동생이 형보다 더 키도 크고 무겁다.
다리 아프이 놀면 가자마.	다리/NNG 아프/VA 이/EC 놀면__2/MAG 가/VV 자마/EF ./SF	다리 아프니 천천히 가자.
그 아는 지는 것얼 아즌 틀려한다.	그/MM 아__23/NNG 는/JX 지/VV 는/ETM 것/NNB 얼/JKO 아즌/MAG 틀려하__1/VV ᆫ다/EF ./SF	그 아이는 지는 것을 아주 싫어한다.
가마니떼기에 쌀이 샬도 없수다레.	가마니떼기/NNG 에/JKB 쌀/NNG 이/JKS 샬__2/NNG 도/JX 없/VA 수다레/EF ./SF	가마니에 쌀이 조금도 없습니다.
너 왜 꼭박이다가 밥얼 먹네?	너/NP 왜/MAG 꼭박__1/NNG 이다가/JKB 밥/NNG 얼/JKO 먹/VV 네/EF ?/SF	너 왜 쪽박에다가 밥을 먹니?
오널 저냑에는 먹대 넣구 지지개럴 낋였다.	오널__1/NNG 저냑__1/NNG 에/JKB 는/JX 먹대__2/NNG 넣/VV 구/EC 지지개/NNG 럴/JKO 낋이__1/VV 었/EP 다/EF ./SF	오늘 저녁에는 오징어 넣고 찌개를 끓였다.
얘, 옆집 아자씨럴 등꼽재이라구 놀리문 안 된다.	얘/IC ,/SP 옆집/NNG 아자씨__1/NNG 럴/JKO 등꼽재이__1/NNG 이/VCP 라구/EC 놀리/VV 문/EC 안/MAG 되/VV ᆫ다/EF ./SF	얘, 옆집 아저씨를 꼽추라고 놀리면 안 된다.
아주마이가 바금태기럴 옆구리에 낑기구 걸어간다.	아주마이__1/NNG 가/JKS 바금태기__1/NNG 럴/JKO 옆구리/NNG 에/JKB 낑기__1/VV 구/EC 걸어가/VV ᆫ다/EF ./SF	아주머니가 바구니를 옆구리에 끼우고 걸어간다.
바당에 떨어진 갈루럴 빗잘루루 쓴다.	바당__1/NNG 에/JKB 떨어지/VV ᆫ/ETM 갈루__1/NNG 럴/JKO 빗잘루__1/NNG 루/JKB 쓸/VV ᆫ다/EF ./SF	바닥에 떨어진 가루를 빗자루로 쓴다.
갓난아이가 오널 돌돌이럴 간다.	갓난아이/NNG 가/JKS 오널__1/NNG 돌돌이__1/NNG 럴/JKO 가/VV ᆫ다/EF ./SF	갓난아이가 오늘 첫나들이를 간다.
동무콰 싸우구 오두니 기분이 터지건한가 보다.	동무/NNG 콰/JC 싸우/VV 구/EC 오/VV 두니/EC 기분/NNG 이/JKS 터지건하__1/VA ᆫ가/EC 보/VX 다/EF ./SF	동무와 싸우고 오더니 기분이 트적지근한가 보다.
나물얼 물에 담가 씬맛얼 없애자마.	나물/NNG 얼/JKO 물/NNG 에/JKB 담그/VV 어/EC 씬맛__1/NNG 얼/JKO 없애/VV 자마/EF ./SF	나물을 물에 담가 쓴맛을 없애자.
그는 기대감으루 가심이 죄릿하였다.	그/NP 는/JX 기대감/NNG 으루/JKB 가심__5/NNG 이/JKS 죄릿하__1/VA 었/EP 다/EF ./SF	그는 기대감으로 가슴이 자릿하였다.
그것은 저기 갱사리게 가져다 놓으러마.	그것/NP 은/JX 저기/NP 갱사리__1/NNG 게/JKB 가지/VV 어다/EC 놓/VX 으러마/EF ./SF	그것은 저기 가장자리에 가져다 놓으려무나.
아들이 풀콰 돌망구럴 가지구 바깜살이럴 하구 있다.	아__23/NNG 들/XSN 이/JKS 풀/NNG 콰/JC 돌망구__1/NNG 럴/JKO 가지/VV 구/EC 바깜살이__1/NNG 럴/JKO 하/VV 구/EC 있/VX 다/EF ./SF	아이들이 풀과 돌멩이를 가지고 소꿉놀이를 하고 있다.
버래에다 남은 쌀얼 담아 놓으러마.	버래__1/NNG 에다/JKB 남/VV 은/ETM 쌀/NNG 얼/JKO 담/VV 어/EC 놓/VX 으러마/EF ./SF	버치에다 남은 쌀을 담아 놓으려무나.
짼지럴 칼돔배기에다 놓구 썰었다.	짼지__1/NNG 럴/JKO 칼돔배기__1/NNG 에다/JKB 놓/VV 구/EC 썰/VV 었/EP 다/EF ./SF	짠지를 칼도마에다 놓고 썰었다.
동상은 동무와 행께 놀루 나갔다.	동상__1/NNG 은/JX 동무/NNG 와/JKB 행께__1/MAG 놀/VV 루/EC 나가/VV 었/EP 다/EF ./SF	동생은 동무와 함께 놀러 나갔다.
뒤르박으루 물얼 길어설라무니 단지에 채워 놓으러마.	뒤르박__1/NNG 으루/JKB 물/NNG 얼/JKO 긷/VV-I 어서/EC ᆯ라무니/EC 단지/NNG 에/JKB 채우/VV 어/EC 놓/VX 으러마/EF ./SF	두레박으로 물을 길어서 단지에 채워 놓으려무나.
큰방이 가서나리 옷당보럴 걷어 오나라.	큰방/NNG 이/JKB 가/VV 어서나리/EC 옷당보__1/NNG 럴/JKO 걷/VV-R 어/EC 오/VV 나라/EF ./SF	큰방에 가서 횃댓보를 걷어 오너라.
머리에 끼낙지럴 깍 동여맸다.	머리/NNG 에/JKB 끼낙지__1/NNG 럴/JKO 깍__7/MAG 동여매/VV 었/EP 다/EF ./SF	머리에 끈을 꼭 동여맸다.
저기 저 볏단얼 매끈으루 묶자요.	저기/NP 저/MM 볏단/NNG 얼/JKO 매끈__2/NNG 으루/JKB 묶/VV 자요/EF ./SF	저기 저 볏단을 매끼로 묶읍시다.
콩묵 마이 넣구 지짐이 끓이자이.	콩묵__1/NNG 마이/NNP 넣/VV 구/EC 지짐이/NNG 끓이/VV 자이/EF ./SF	두부 많이 넣고 지짐이 끓이자.
아가 돌팡매럴 맞아설라무니 다쳤댜.	아__23/NNG 가/JKS 돌팡매__1/NNG 럴/JKO 맞/VV 어서/EC ᆯ라무니/EC 다치/VV 었/EP 댜/EF ./SF	아이가 돌팔매를 맞아서 다쳤대.
저냑꺼정 지벅지에다 물얼 다 채워 놓으러마.	저냑__1/NNG 꺼정/JX 지벅지__1/NNG 에다/JKB 물/NNG 얼/JKO 다/MAG 채우/VV 어/EC 놓/VX 으러마/EF ./SF	저녁까지 물독에다 물을 다 채워 놓으려무나.
그 깍다시느 잘 먹지두 않두나.	그/MM 깍다시__1/NNG 느/JX 잘/MAG 먹/VV 지/EC 두/JX 않/VX 두나/EF ./SF	그 말라깽이는 잘 먹지도 않더구나.
돈은 개벽이다가 잘 넣으러마.	돈/NNG 은/JX 개벽__6/NNG 이다가/JKB 잘/MAG 넣/VV 으러마/EF ./SF	돈은 주머니에다가 잘 넣으려무나.
강아지럴 혼달궜두니 구석이 숨어 베렸다.	강아지/NNG 럴/JKO 혼달구__1/VV 었/EP 두니/EC 구석/NNG 이/JKB 숨/VV 어/EC 베리__1/VX 었/EP 다/EF ./SF	강아지를 혼냈더니 구석에 숨어 버렸다.
으른덜 충고럴 잘 예겨들어라.	으른/NNG 덜/XSN 충고/NNG 럴/JKO 잘/MAG 예기__1/VV 어/EC 듣/VV-I 어라/EF ./SF	어른들 충고를 잘 여겨들어라.
그 아는 생김새는 안 그란데 하넌 짓이 별랗다.	그/MM 아__23/NNG 는/JX 생김새/NNG 는/JX 안/MAG 그랗/VA ᆫ데/EC 하/VV 넌/ETM 짓/NNG 이/JKS 별랗/VA-I 다/EF ./SF	그 아이는 생김새는 안 그런데 하는 짓이 별나다.
암탈기가 펭아리럴 품구 있다.	암탈기__1/NNG 가/JKS 펭아리__1/NNG 럴/JKO 품/VV 구/EC 있/VX 다/EF ./SF	암탉이 병아리를 품고 있다.
동상이 성 패이럴 쑝톨했다.	동상__/NNG 이/JKS 성__5/NNG 패이__1/NNG 럴/JKO 쑝톨하__1/VV 었/EP 다/EF ./SF	동생이 형 팽이를 훔쳤다.
국마룩만 먹지 말구 군덕지두 좀 먹으러마.	국마룩__1/NNG 만/JX 먹/VV 지/EC 말/VX 구/EC 군덕지__1/NNG 두/JX 좀/MAG 먹/VV 으러마/EF ./SF	국물만 먹지 말고 건더기도 좀 먹으려무나.
아들은 온할레럴 배깥서 보낸다.	아들/NNG 은/JX 온할레__1/NNG 럴/JKO 배깥__1/NNG 서/JKB 보내/VV ᆫ다/EF ./SF	아이들은 온종일을 바깥에서 보낸다.
나는 식성이 패로워서나무리 국수만 잘 묵는다.	나/NP 는/JX 식성/NNG 이/JKS 패롭__1/VA-I 어서/EC 나무리/EC 국수/NNG 만/JX 잘/MAG 묵__4/VV 는다/EF ./SF	나는 식성이 까다로워서 국수만 잘 먹는다.
밭에 나가 풀얼 변다.	밭/NNG 에/JKB 나가/VV 어/EC 풀/NNG 얼/JKO 벼__1/VV ᆫ다/EF ./SF	밭에 나가 풀을 벤다.
나는 갭차기서 굠얼 꺼내 동상한데 주었다.	나/NP 는/JX 갭차기__1/NNG 서/JKB 굠__1/NNG 얼/JKO 꺼내/VV 어/EC 동상__1/NNG 한데/JKB 주/VV 었/EP 다/EF ./SF	나는 주머니에서 고욤을 꺼내 동생한테 주었다.
그 사램이 내 주머니럴 쏭해서 달아났다.	그/MM 사램__1/NNG 이/JKS 나/NP 의/JKG 주머니/NNG 럴/JKO 쏭하__1/VV 어서/EC 달아나/VV 었/EP 다/EF ./SF	그 사람이 내 주머니를 훔쳐서 달아났다.
방이 돼지우랑치럼 찌끈하다.	방/NNG 이/JKS 돼지우랑__1/NNG 치럼/JKB 찌끈하__4/VA-I 다/EF ./SF	방이 돼지우리처럼 더럽다.
넘얼 욕하는 말언 아씨 무시하러마.	넘__2/NNG 얼/JKO 욕하/VV 는/ETM 말/NNG 언/JX 아씨__2/MAG 무시/NNG 하/XSV 러마/EF ./SF	남을 욕하는 말은 아예 무시하려무나.
아는 바금태기럴 팡갈해 두구 밖으루 놀러 나갔다.	아__23/NNG 는/JX 바금태기__1/NNG 럴/JKO 팡갈하__1/VV 어/EC 두/VX 구/EC 밖/NNG 으루/JKB 놀/VV 러/EC 나가/VV 었/EP 다/EF ./SF	아이는 바구니를 팽개쳐 두고 밖으로 놀러 나갔다.
비가 오두니 강냉이래 게유 한 뼘 자랐다.	비/NNG 가/JKS 오/VV 두니/EC 강냉__1/NNG 이래/JKS 게유__2/MAG 한/MM 뼘/NNB 자라/VV 었/EP 다/EF ./SF	비가 오더니 옥수수가 겨우 한 뼘 자랐다.
불 때는 아궁이에 구들장 놓고 헉으로 발르구.	불/NNG 때/VV 는/ETM 아궁이/NNG 에/JKB 구들장/NNG 놓/VV 고/EC 헉__4/NNG 으로/JKB 발르__1/VV 구/EF ./SF	불 때는 아궁이에 구들장 놓고 흙으로 바르구.
오늘 저냑에는 쑥갇얼 넣구 국마룩얼 낋여 먹었수다레.	오늘/NNG 저냑__1/NNG 에/JKB 는/JX 쑥갇__1/NNG 얼/JKO 넣/VV 구/EC 국마룩__1/NNG 얼/JKO 낋이/VV 어/EC 먹/VV 었/EP 수다레/EF ./SF	오늘 저녁에는 쑥갓을 넣고 국을 끓여 먹었습니다.
건거이가 샬 맹태다.	건거이/NNG 가/JKS 샬__2/NNG 맹태__1/VA-I 다/EF ./SF	반찬이 조금 싱겁다.
동상이 성에게 감재럴 뺏걸렸다.	동상__1/NNG 이/JKS 성__5/NNG 에게/JKB 감재__1/NNG 럴/JKO 뺏걸리__1/VV 었/EP 다/EF ./SF	동생이 형에게 감자를 빼앗겼다.
그 아는 실수 한 번우루 넘으 입지가리에 오르내렸다.	그/MM 아__23/NNG 는/JX 실수/NNG 한/MM 번/NNB 우루/JKB 넘__2/NNG 으/EC 입지가리__1/NNG 에/JKB 오르내리/VV 었/EP 다/EF ./SF	그 아이는 실수 한 번으로 남의 입길에 오르내렸다.
식량이 세날밖이 없으니까니 애껴 묵어야 한다.	식량/NNG 이/JKS 세날__1/NNG 밖/NNG 이/JKB 없/VA 으니까니/EC 애끼__1/VV 어/EC 묵__4/VV 어야/EC 하/VX ᆫ다/EF ./SF	식량이 조금밖에 없으니까 아껴 먹어야 한다.
아가 장헉으루 인형얼 맨든다.	아__23/NNG 가/JKS 장헉__1/NNG 으루/JKB 인형/NNG 얼/JKO 맨들__3/VV ᆫ다/EF ./SF	아이가 찰흙으로 인형을 만든다.
겹우테만 입었데니 으슬으슬하다.	겹우테__1/NNG 만/JX 입/VV-R 었/EP 데니/EC 으슬으슬/MAG 하/XSA 다/EF ./SF	겹옷만 입었더니 으슬으슬하다.
비가 오니까니 아덜은 인침 집이루 돌아왔다.	비/NNG 가/JKS 오/VV 니까니/EC 아__23/NNG 덜/XSN 은/JX 인침__3/MAG 집/NNG 이루/JKB 돌아오/VV 었/EP 다/EF ./SF	비가 오니까 아이들은 이내 집으로 돌아왔다.
날이 풀리이 논이서 먹자구리가 시끄럽게 운다.	날/NNG 이/JKS 풀리/VV 이/EC 논/NNG 이서/JKB 먹자구리__1/NNG 가/JKS 시끄럽/VA-I 게/EC 울/VV ᆫ다/EF ./SF	날이 풀리니 논에서 개구리가 시끄럽게 운다.
아덜이 개골이서 진채비럴 잡구 있수다레.	아__23/NNG 덜/XSN 이/JKS 개골__3/NNG 이서/JKB 진채비__1/NNG 럴/JKO 잡/VV-R 구/EC 있/VX 수다레/EF ./SF	아이들이 개울에서 잔고기를 잡고 있습니다.
내 셈으루 이 바우는 들지 못한다.	나/NP 의/JKG 셈__13/NNG 으루/JKB 이/MM 바우__1/NNG 는/JX 들/VV 지/EC 못하/VX ᆫ다/EF ./SF	내 힘으로 이 바위는 들지 못한다.
밭일 시딱 끝내구 밥 묵자야.	밭일/NNG 시딱__1/MAG 끝내/VV 구/EC 밥/NNG 묵__4/VV 자/EF 이/VCP 야/EF ./SF	밭일 후딱 끝내고 밥 먹자.
아가 팔꼬배럴 괴구 앉았다.	아__23/NNG 가/JKS 팔꼬배__1/NNG 럴/JKO 괴/VV 구/EC 앉/VV 었/EP 다/EF ./SF	아이가 팔꿈치를 괴고 앉았다.
그는 괴기럴 집쑷고는 인침 샘키었다.	그/NP 는/JX 괴기__6/NNG 럴/JKO 집쑷__1/VV-R 고/EC 는/JX 인침__3/MAG 샘키/VV 었/EP 다/EF ./SF	그는 고기를 짓씹고는 이내 삼키었다.
난 동구막질하고 싶은 마엄이 쌸도 없어야.	나/NP ᆫ/JX 동구막질__1/NNG 하/XSV 고/EC 싶/VX 은/ETM 마엄/NNG 이/JKS 쌸__1/NNG 도/JX 없/VA 어야/EF ./SF	난 소꿉놀이하고 싶은 마음이 조금도 없어.
이 무느 턱장없이 비싸두나.	이/MM 무/NNG 느/JX 턱장없이__1/MAG 비싸/VA 두나/EF ./SF	이 무는 턱없이 비싸더구나.
우리 동네 아이들이 숨귀박질얼 헌다.	우리/NP 동네/NNG 아이/NNG 들/XSN 이/JKS 숨귀박질__1/NNG 얼/JKO 허/VV ᆫ다/EF ./SF	우리 동네 아이들이 숨바꼭질을 한다.
뙹그만 거 먹는 게, 우려서 아린 맛이야 덜하갓지.	뙹그마__1/VA ᆫ/ETM 거/NNB 먹/VV 는/ETM 것/NNB 이/JKS ,/SP 우리/VV 어서/EC 아리/VA ᆫ/ETM 맛/NNG 이야/JX 덜/MAG 하/VV 갓/EP 지/EF ./SF	똥그란 거 먹는 게, 우려서 아린 맛이야 덜하겠지.
나는 그 녀자의 우티가 발가웠다.	나/NP 는/JX 그/MM 녀자/NNG 의/JKG 우티__1/NNG 가/JKS 발갑__1/VA-I 었/EP 다/EF ./SF	나는 그 여자의 옷이 부러웠다.
이자 쌀쉬수도 세날 남았수다레.	이자__1/MAG 쌀쉬수__1/NNG 도/JX 세날__1/NNG 남/VV 었/EP 수다레/EF ./SF	이제 쌀수수도 조금 남았습니다.
배깥이 마이 취우니 나가지 말래라.	배깥__1/NNG 이/JKS 마이__1/MAG 췹__1/VA-I 으니/EC 나가/VV 지/EC 말/VX 래라/EF ./SF	바깥이 많이 추우니 나가지 말라고 해라.
저냑이 되어 동구막질은 허지부지 끝났다.	저냑__1/NNG 이/JKC 되/VV 어/EC 동구막질__1/NNG 은/JX 허지부지__1/MAG 끝나/VV 었/EP 다/EF ./SF	저녁이 되어 소꿉놀이는 흐지부지 끝났다.
한냠은 열여섯에 우리 아바니럴 낳았다.	한냠__1/NNG 은/NNG 열/NR 여섯/NR 에/JKB 우리/NP 아바니__1/NNG 럴/JKO 낳/VV 었/EP 다/EF ./SF	할머니는 열여섯에 우리 아버지를 낳았다.
아는 오마니 앞이서 책얼 줄줄 외었다.	아__23/NNG 는/JX 오마니__1/NNG 앞/NNG 이서/JKB 책/NNG 얼/JKO 줄줄/MAG 외우/VV 었/EP 다/EF ./SF	아이는 어머니 앞에서 책을 줄줄 외웠다.
짐치가 맹태니까니 샤우젇얼 더 넣으러마.	짐치__1/NNG 가/JKS 맹태__1/VA 니까니/EC 샤우젇__1/NNG 얼/JKO 더/MAG 넣/VV 으러마/EF ./SF	김치가 싱거우니까 새우젓을 더 넣으려무나.
그 아자씨는 우리 집이서 허푸살이럴 하든 사람이었다.	그/MM 아자씨__1/NNG 는/JX 우리/NP 집/NNG 이서/JKB 허푸살이__1/NNG 럴/JKO 하/VV 든/ETM 사람/NNG 이/VCP 었/EP 다/EF ./SF	그 아저씨는 우리 집에서 머슴살이를 하던 사람이었다.
밤얼 꼬똑 새서나리 바느질얼 했다.	밤/NNG 얼/JKO 꼬똑__1/MAG 새/VV 어서나리/EC 바느질/NNG 얼/JKO 하/VV 었/EP 다/EF ./SF	밤을 꼬박 새서 바느질을 했다.
여태끈 집이 안 가구 뭐 하네?	여태끈__1/MAG 집/NNG 이/JKB 안/MAG 가/VV 구/EC 뭐/NP 하/VV 네/EF ?/SF	여태껏 집에 안 가고 뭐 하니?
국마락이 맹태니까니 소곰얼 타서 먹으러마.	국마락__1/NNG 이/JKS 맹태__1/VA 니까니/EC 소곰__3/NNG 얼/JKO 타/VV 어서/EC 먹/VV 으러마/EF ./SF	국물이 싱거우니까 소금을 타서 먹으려무나.
아바니는 떠락지에 장재기럴 쌓아 두었다.	아바니__1/NNG 는/JX 떠락지__1/NNG 에/JKB 장재기__1/NNG 럴/JKO 쌓/VV 어/EC 두/VX 었/EP 다/EF ./SF	아버지는 뜨락에 장작을 쌓아 두었다.
얻어먹기 트사스러워서 기냥 안 먹는다.	얻어먹/VV 기/ETN 트사스럽__1/VA-I 어서/EC 기냥__1/MAG 안/MAG 먹/VV 는다/EF ./SF	얻어먹기 치사스러워서 그냥 안 먹는다.
아가 놀래서나리 묵던 것얼 꼴뚝 넘겼다.	아__23/NNG 가/JKS 놀래/VV 어서나리/EC 묵__4/VV 던/ETM 것/NNB 얼/JKO 꼴뚝__1/MAG 넘기/VV 었/EP 다/EF ./SF	아이가 놀래서 먹던 것을 꼴깍 넘겼다.
코찔찔이가 그 길자럴 어찌 알갔니?	코찔찔이__1/NNG 가/JKS 그/MM 길자__1/NNG 럴/JKO 어찌/MAG 알/VV 갔/EP 니/EF ?/SF	코흘리개가 그 글자를 어찌 알겠니?
바즈래기 넣구 뜨더국 낋여 줄게.	바즈래기__1/NNG 넣/VV 구/EC 뜨더국/NNG 낋이__1/VV 어/EC 주/VX ᆯ게/EF ./SF	바지락 넣고 수제비 끓여 줄게.
불얼 오래 피웠드니 피겁다.	불어/NNP ᆯ/JKO 오래/MAG 피우/VV 었/EP 드니/EC 피겁__1/VA-R 다/EF ./SF	불을 오래 피웠더니 냅다.	불/NNG 을/JKO 오래/MAG 피우/VV 었/EP 더니/EC 냅다/MAG ./SF
구뚜막에 노그제럴 잘 닦아 놓으러마.	구뚜막/NNP 에/JKB 노그제__1/NNG 럴/NNP 잘/MAG 닦/VV 어/EC 놓/VX 으러/EC 마/EF ./SF	부뚜막에 가마솥을 잘 닦아 놓으려무나.	부뚜막/NNG 에/JKB 가마솥/NNG 을/JKO 잘/MAG 닦/VV 어/EC 놓/VX 으려/EC 물/VV 나/EF ./SF
서두르디 말구 노낭 오나라.	서두르/VV 디/EC 말/VV 구/EC 노낭__1/MAG 오나라/NNP ./SF	서두르지 말고 천천히 오너라.	서두르/VV 지/EC 말/VX 고/EC 천천히/MAG 오/VV 너라/EF ./SF
여기서는 다 품깝 받는다고 해.	여기/NP 서/JKB 는/JX 다/MAG 품깝__1/NNG 받/VV-R 는다고/EC 하/VV 어/EF ./SF	여기서는 다 품값 받는다고 해.	여기/NP 서/JKB 는/JX 다/MAG 품값/NNG 받/VV-R 는다고/EC 하/VV 어/EF ./SF
사가 사구 서파 잘 챙겨 오나라.	사/NR 가/JKS 사/NR 구/NR 서파__4/NNG 잘/MAG 챙기/VV 어/EC 오/NR 나라/NNG ./SF	사과 사고 거스름 잘 챙겨 오너라.	사과/NNG 사/VV 고/EC 거스르/VV ᆷ/ETN 잘/MAG 챙기/VV 어/EC 오/VV 너라/EF ./SF
