팡구에 부테소니래 한머사니 잇수다.	팡구__1/NNG 에/JKB 부테소니__1/NNG 래/JKS 한머사니__1/MAG 잇/VA-R 수다/EF ./SF	바위에 부처손이 많이 있습니다.
다네 왜큰마니래 오신다는 날이 오늘이 맞네?	다/NP 네/XSN 왜큰마니__1/NNG 래/JKS 오/VV 시/EP ᆫ다는/ETM 날/NNG 이/JKS 오늘/NNG 이/JKS 맞/VV 네/EF ?/SF	쟤네 외할머니가 오신다는 날이 오늘이 맞니?
깍 깨밀어라.	깍__7/MAG 깨밀__1/VV 어라/EF ./SF	꼭 깨물어라.
내래 초개마가리를 해두 신세는 기티디 않을 겁네다.	나/NP 래/JKS 초개마가리__1/NNG 를/JKO 하/VV 어두/EC 신세/NNG 는/JX 기티/VV 디/EC 않/VX 을/ETM 거/NNB 이/VCP ᆸ네다/EF ./SF	내가 오막살이를 해도 신세는 끼치지 않을 겁니다.
아들놈이 글을 잘 따루내니끼니까 공부를 더 가르체야 하갓수다.	아들놈/NNG 이/JKS 글/NNG 을/JKO 잘/MAG 따루내__1/VV 니끼니까/EC 공부/NNG 를/JKO 더/MAG 가르체__1/VV 어야/EF 하/VX 갓/EP 수다/EF ./SF	아들놈이 글을 잘 외니 공부를 더 가르쳐야 하겠습니다.
당사하는 건 중국 사람이 잘합네다.	당사하__3/VV 는/ETM 거/NNB ᆫ/JX 중국/NNP 사람/NNG 이/JKS 잘/MAG 하/VX ᆸ네다/EF ./SF	장사하는 건 중국 사람이 잘합니다.
가는 어드래서 데맇게 왁자지근하네	가/NP 는/JX 어드래서/MAG 데맇/VA-I 게/EC 왁자지근하__1/VV 네/EF	걔는 어째서 저렇게 왁자지껄하니?
쌈지래 큰아바지 오른켄에 잇이요.	쌈지/NNG 래/JKS 큰아바지__1/NNG 오른켄__1/NNG 에/JKB 잇/VA-R 이요/EF ./SF	쌈지가 할아버지 오른편에 있어요.
넢구리가 께낀하니끼니 날래 털라요.	넢구리__1/NNG 가/JKS 께낀하__1/VA 니끼니/EC 날래__1/MAG 털/VV 라요/EF ./SF	옆구리가 더러우니까 빨리 터세요.
닛못이 아푸문 고상이 막심합네다.	닛못__1/NNG 이/JKS 아푸/VA 문/EC 고상__1/NNG 이/JKS 막심/NNG 하/XSV ᆸ네다/EF ./SF	잇몸이 아프면 고생이 막심합니다.
냥디에는 발쎄 눈이 다 녹앗디요.	냥디__1/NNG 에/JKB 는/JX 발쎄__2/MAG 눈/NNG 이/JKS 다/MAG 녹/VV 엇/EP 디요/EF ./SF	양지에는 벌써 눈이 다 녹았지요.
소는 비싸니끼니 소왕간에 쇄지나 싸다 넣구 멕이시라요. 	소/NNG 는/JX 비싸/VA 니끼니/EC 소왕간__1/NNG 에/JKB 쇄지__2/NNG 나/JC 싸__21/VV 다/EF 넣/VV 구/EC 멕이__1/VV 시/EP 라요/EF ./SF	소는 비싸니까 외양간에 송아지나 사다 넣고 먹이세요.
댜네 집 보리농구래 다 닉엇갓디?	댜/NP 네/XSN 집/NNG 보리농구__1/NNG 래/JKS 다/MAG 닉/VV 엇/EP 갓/EP 디/EF ?/SF	쟤네 집 자두가 다 익었겠지?
더기 가는 체네래 앞집 아즈바이 왜손네웨다.	더기__3/NP 가/VV 는/ETM 체네__1/NNG 래/JKS 앞집/NNG 아즈바이__1/NNG 왜손네__1/NNG 이/VCP 웨다/EF ./SF	저기 가는 처녀가 앞집 아저씨 외손녀외다.
웬일인디 왜클아바지래 자무런 말씀이 없엇이요. 	웬일/NNG 이/VCP ᆫ디/EC 왜클아바지__1/NNG 래/JKS 자무런/MM 말씀/NNG 이/JKS 없/VA 엇/EP 이요/JX ./SF	웬일인지 외할아버지가 아무런 말씀이 없었어요.
나케 오롯길루 가야갓다.	나케__1/MAG 오롯길__1/NNG 루/JKB 가/VV 어야/EC 갓/EP 다/EF ./SF	이따가 오솔길로 가야겠다.
국마룩이 식지 않게 가마뚜껑얼 깍 닫았다.	국마룩__1/NNG 이/JKS 식/VV 지/EC 않/VX 게/EC 가마/NNG 뚜껑/NNG 얼/JKO 깍__7/MAG 닫/VV-R 었/EP 다/EF ./SF	국물이 식지 않게 솥뚜껑을 꼭 닫았다.
산에 갈 때 굴걱지 개지구 나가는 거 닞디 말라우.	산/NNG 에/JKB 가/VV ᆯ/ETM 때/NNG 굴걱지__1/NNG 개지__1/VV 구/EC 나가/VV 는/ETM 거/NNB 닞/VV 디/EC 말/VX 라우/EF ./SF	산에 갈 때 옷 가지고 나가는 것 잊지 마라.
와 기케 술을 딜이마시네?	와__7/MAG 기케/MAG 술/NNG 을/JKO 딜이마시__1/VV 네/EF ?/SF	왜 그렇게 술을 들이마시니?
잔챗집이란 거저 데렇게 왁자지근한 거웨다.	잔챗집__1/NNG 이란/JX 거저/MAG 데렇__1/VA-I 게/EC 왁자지근/XR 하/XSA ᆫ/ETM 거/NNB 이/VCP 웨다/EF ./SF	잔칫집이란 그저 저렇게 왁자지껄한 것입니다.
가래 왠손좨기라 왠손으루 글씨를 씁네다.	가/NP 래/JKS 왠손좨기__1/NNG 이/VCP 라/EC 왠손__1/NNG 으루/JKB 글씨/NNG 를/JKO 쓰/VV ᆸ네다/EF ./SF	개가 왼손잡이라 왼손으로 글씨를 씁니다.
젠에 사람들이야 자동고를 안 배왓이요.	젠/NNG 에/JKB 사람/NNG 들/XSN 이야/JX 자동고__1/NNG 를/JKO 안/MAG 배오__1/VV 엇/EP 이요/EF ./SF	전에 사람들이야 자전거를 안 배웠어요.
삽 소리 디끄룹다. 꿀구 가디 말라.	삽/NNG 소리/NNG 디끄룹__1/VA-R 다/EF ./SF 꿀/VV 구/EC 가/VV 디/EC 말/VX 라/EF ./SF	삽 소리 듣그럽다. 끌고 가지 말아라.
세 잇디 말구 얼등 앉으람.	세__20/VV 어/EC 잇/VX-R 디/EC 말/VX 구/EC 얼등__1/MAG 앉/VV 으람/EF ./SF	서 있지 말고 어서 앉으렴.
그지께 일루 상게두 나무럽습메까?	그지께__1/NNG 일/NNG 루/JKB 상게__1/MAG 두/JX 나무럽__1/VA-I 습메까/EF ?/SF	그저께 일로 아직도 노엽습니까?
동제맨 바오래기래 다 끄켓수다.	동제매__1/VV ᆫ/ETM 바오래기__1/NNG 래/JKS 다/MAG 끄키__1/VV 엇/EP 수다/EF ./SF	동여맨 바오라기가 다 끊겼습니다.
넷날 냬기는 해서 뭐 하간?	넷날__1/NNG 냬기__1/NNG 는/JX 하/VV 어서/EC 뭐/NP 하/VV 간/EF ?/SF	옛날 이야기는 해서 뭐 하겠니?
더기 낭짝에 앉아 잇는 거이 누구가?	더기__3/NP 낭짝__1/NNG 에/JKB 앉/VV 어/EC 잇/VX-R 는/ETM 거/NNB 이/JKS 누구/NP 이/VCP 가/EF ?/SF	저기 양지쪽에 앉아 있는 게 누구냐?
쌀 그르구 땔깜두 준비해야디.	쌀/NNG 그르구__1/MAG 땔깜/NNG 두/JX 준비/NNG 하/XSV 어야디/EF ./SF	쌀 그리고 땔감도 준비해야지.
닞디 말구 넝수증을 받아 오시라요.	닞/VV 디/EC 말/VX 구/EC 넝수증__1/NNG 을/JKO 받/VV-R 어/EC 오/VV 시/EP 라요/EF ./SF	잊지 말고 영수증을 받아 오세요.
산맑에 오루니끼니 정말루 상쾌허우다레.	산맑__1/NNG 에/JKB 오루/VV 니끼니/EC 정말루/MAG 상쾌/XR 허/XSA 우다레/EF ./SF	산마루에 오르니까 정말로 상쾌합니다그려.
산에 부즈런히 올라갓다 왓수다.	산/NNG 에/JKB 부즈런히__1/MAG 올라가/VV 엇/EP 다/EC 오/VV 엇/EP 수다/EF ./SF	산에 부지런히 올라갔다 왔습니다.
내래 그 소식을 알괫디.	나/NP 래/JKS 그/MM 소식/NNG 을/JKO 알괘__1/VV 엇/EP 디/EF ./SF	내가 그 소식을 알렸지.
내래 메쌀가루루 맨든 거, 젤펜 돟아해요.	나/NP 래/JKS 메쌀__1/NNG 가루/NNG 루/JKB 맨들/VV ᆫ/ETM 거/NNB ,/SP 젤펜__1/NNG 돟__1/VA 어/EC 하/VX 어요/EF ./SF	내가 멥쌀가루로 만든 거, 절편 좋아해요.
절게방은 뭐 하레 갑마?	절게방__1/NNG 은/JX 뭐/NP 하/VV 레/EC 가/VV ᆸ마/NNG ?/SF	머슴방은 뭐 하러 가는가?
한딧잠 잘 땐 누덩불이나 피워야디 딴 도리래 잇갓이요?	한딧잠__1/NNG 자/VV ᆯ/ETM 때/NNG ᆫ/JX 누덩불__1/NNG 이나/JC 피우/VV 어야디/EC 딴/MM 도리/NNG 래/JKS 잇/VV-R 갓/EP 이요/EF ?/SF	한뎃잠 잘 땐 모닥불이나 피워야지 다른 도리가 있겠어요?
우리 동무터럼 성하게 디냅세다.	우리/NP 동무/NNG 터럼__1/JKB 성하__9/VA 게/EC 디내/VV ᆸ세다/EF ./SF	우리 동무처럼 허물없게 지냅시다.
가래 한 삼십 나서 당개갓이요.	가/NP 래/JKS 한/MM 삼/NR 십/NR 나/VV 어서/EC 당개__1/NNB 가/VV 엇/EP 이요/EF ./SF	걔가 한 서른 살 되어서 장가갔어요.
가 오정 쌋나 보구레.	가/NP 오정__6/NNG 싸/VV 엇/EP 나/EC 보/VX 구레/EF ./SF	그 아이 오줌 쌌나 보구려.
삼춘오마니는 당사를 잘 못함메.	삼춘오마니__1/NNG 는/JX 당사/NNG 를/JKO 잘/MAG 못/MAG 하/VV ᆷ메/EF ./SF	작은어머니는 장사를 잘 못하네.
솔가래가 많이 쌓였다.	솔가래__1/NNG 가/JKS 많이/MAG 쌓이/VV 었/EP 다/EF ./SF	솔가리가 많이 쌓였다.
