무난해서 좋습니다,.	무난/XR 하/XSA 여서/EC 좋/VA 습니다/EF ,/SP ./SF
봉건사회 해체 및 자본주의 맹아론: 20세기 아시아 사회를 정체론으로 인식한 서양중심주의 역사인식(한국의 경우 일제의 식민사관)에 대응하여 자본주의적 맹아의 검출을 위해 내재적 발전 역사를 검증하려는 연구방법론.	봉건/NNG 사회/NNG 해체/NNG 및/MAJ 자본주의/NNG 맹아/NNG 론/XSN :/SP 20/SN 세기/NNB 아시아/NNP 사회/NNG 를/JKO 정체/NNG 론/XSN 으로/JKB 인식/NNG 하/XSV ㄴ/ETM 서양/NNG 중심주의/NNG 역사/NNG 인식/NNG (/SSO 한국/NNP 의/JKG 경우/NNG 일제/NNG 의/JKG 식민/NNG 사관/NNG )/SSC 에/JKB 대응/NNG 하/XSV 여/EC 자본주의/NNG 적/XSN 맹아/NNG 의/JKG 검출/NNG 을/JKO 위하/VV 여/EC 내재/NNG 적/XSN 발전/NNG 역사/NNG 를/JKO 검증/NNG 하/XSV 려는/ETM 연구/NNG 방법/NNG 론/XSN ./SF
미스크가 없어서 주문해서 쓰긴 하네요 예전엔 무지 쌌는데~	미스크/NNG 가/JKS 없/VA 어서/EC 주문/NNG 하/XSV 여서/EC 쓰/VV 기/ETN ㄴ/JX 하/VX 네요/EF 예전/NNG 에/JKB ㄴ/JX 무지/MAG 싸/VA 았/EP 는데/EC ~/SO
순정보다 확실히 밝아요 시인성 좋은거 같아요 포장도 꼼꼼이 잘해서 왔구요 배송도 빨랐어요	순정/NNG 보다/JKB 확실히/MAG 밝/VA 아요/EF 시인/NNG 성/XSN 좋/VA 은/ETM 것/NNB 같/VA 아요/EF 포장/NNG 도/JX 꼼꼼이/MAG 잘/MAG 하/XSV 여서/EC 오/VV 았/EP 구요/EC 배송/NNG 도/JX 빠르/VA 았/EP 어요/EF
가게를 운영하는 사장님께서 대신 구매 해달라고 하셔서 구매하게되었는데 가게에 달아놓으니까 이쁘네요	가게/NNG 를/JKO 운영/NNG 하/XSV 는/ETM 사장/NNG 님/XSN 께서/JKS 대신/NNG 구매/NNG 하/XSV 여/EC 달/VX 라고/EC 하/VV 시/EP 어서/EC 구매/NNG 하/XSV 게/EC 되/VV 었/EP 는데/EC 가게/NNG 에/JKB 달/VV 아/EC 놓/VX 으니까/EC 이쁘/VA 네요/EF
아무도움 안되요. 쓰고 바로 쓰레기통으로	아무/MM 도움/NNG 안/MAG 되/VV 어요/EF ./SF 쓰/VV 고/EC 바로/MAG 쓰레기통/NNG 으로/JKB
전역적 질의확장: 이용자가 입력한 원래의 질의어와 유사한 용어를 자동으로 추가하거나(자동 질의확장), 이용자가 선택하여 추가하는(상호작용적 질의확장) 기법.	전역/NNG 적/XSN 질의/NNG 확장/NNG :/SP 이용자/NNG 가/JKS 입력/NNG 하/XSV ㄴ/ETM 원래/NNG 의/JKG 질의어/NNG 와/JKB 유사/NNG 하/XSA ㄴ/ETM 용어/NNG 를/JKO 자동/NNG 으로/JKB 추가/NNG 하/XSV 거나/EC (/SSO 자동/NNG 질의/NNG 확장/NNG )/SSC ,/SP 이용자/NNG 가/JKS 선택/NNG 하/XSV 여/EC 추가/NNG 하/XSV 는/ETM (/SSO 상호/NNG 작용/NNG 적/XSN 질의/NNG 확장/NNG )/SSC 기법/NNG ./SF
상대연대: 어떤 사건이 다른 사건보다 앞서 일어났는지, 뒤에 일어났는지, 혹은 동시대인지만을 따지는 연대결정법. 정확한 발생연도는 알 수 없지만, 상대적 순서만으로도 과거의 발전 양상들을 연구할 수 있음.	상대/NNG 연대/NNG :/SP 어떤/MM 사건/NNG 이/JKS 다른/MM 사건/NNG 보다/JKB 앞서/VV 어/EC 일어나/VV 았/EP 는지/EC ,/SP 뒤/NNG 에/JKB 일어나/VV 았/EP 는지/EC ,/SP 혹은/MAJ 동시대/NNG 이/VCP ㄴ지/EC 만/JX 을/JKO 따지/VV 는/ETM 연대/NNG 결정/NNG 법/XSN ./SF 정확/XR 하/XSA ㄴ/ETM 발생/NNG 연도/NNG 는/JX 알/VV ㄹ/ETM 수/NNB 없/VA 지만/EC ,/SP 상대/NNG 적/XSN 순서/NNG 만/JX 으로/JKB 도/JX 과거/NNG 의/JKG 발전/NNG 양상/NNG 들/XSN 을/JKO 연구/NNG 하/XSV ㄹ/ETM 수/NNB 있/VA 음/ETN ./SF
블랙은 딸이 가져가 버렸네요 ^^ 블랙은 어디에나 다 잘어울려서 활용도가 높아요	블랙/NNG 은/JX 딸/NNG 이/JKS 가져가/VV 아/EC 버리/VX 었/EP 네요/EF ^^/SW 블랙/NNG 은/JX 어디/NP 에/JKB 나/JX 다/MAG 잘/MAG 어울리/VV 어서/EC 활용/NNG 도/NNG 가/JKS 높/VA 아요/EF
앞으로 할 일 * 윤곽선 렌더링 * xml 파일에서 게임 레벨 데이터 읽어오기 * 대형 맵 렌더링 최적화 * 모델링ㅋ * 레벨 에디팅용 3dsmax 스크립트 작성	앞/NNG 으로/JKB 하/VV ㄹ/ETM 일/NNG */SW 윤곽선/NNG 렌더링/NNG */SW xml/SL 파일/NNG 에서/JKB 게임/NNG 레벨/NNG 데이터/NNG 읽/VV 어/EC 오/VX 기/ETN */SW 대형/NNG 맵/NNG 렌더링/NNG 최적/NNG 화/XSN */SW 모델링/NNG ㅋ/SW */SW 레벨/NNG 에디팅/NNG 용/XSN 3/SN dsmax/SL 스크립트/NNG 작성/NNG
어렸을때 목요일마다 미사 후에 성체강복을 했었는데, 그때 신부님이 저 노래를 라틴어로 불렀던게 아직도 기억에 남네요. 초등학생이 보기에는 라틴어 노래가 얼마나 웃겼던지... 하도 웃다가 혼나고 쫓겨난적이 한둘이 아닌데	어리/VA 었/EP 을/ETM 때/NNG 목요일/NNG 마다/JX 미사/NNG 후/NNG 에/JKB 성체/NNG 강복/NNG 을/JKO 하/VV 였었/EP 는데/EC ,/SP 그/MM 때/NNG 신부/NNG 님/XSN 이/JKS 저/MM 노래/NNG 를/JKO 라틴어/NNP 로/JKB 부르/VV 었/EP 던/ETM 것/NNB 이/JKS 아직/MAG 도/JX 기억/NNG 에/JKB 남/VV 네요/EF ./SF 초등학생/NNG 이/JKS 보/VV 기/ETN 에/JKB 는/JX 라틴어/NNP 노래/NNG 가/JKS 얼마나/MAG 웃기/VV 었/EP 던지/EF .../SF 하도/MAG 웃/VV 다가/EC 혼나/VV 고/EC 쫓겨나/VV ㄴ/ETM 적/NNB 이/JKS 한둘/NR 이/JKC 아니/VCN ㄴ데/EC
나름튼튼하고 잘쓸수있을것같습니다 이가격에 이퀄리티면 훌륭하죠	나름/NNB 튼튼/XR 하/XSA 고/EC 잘쓰/VV ㄹ/ETM 수/NNB 있/VA 을/ETM 것/NNB 같/VA 습니다/EF 이/MM 가격/NNG 에/JKB 이/MM 퀄리티/NNG 이/VCP 면/EC 훌륭하/VA 죠/EF
입구가 조금 좁은거 말곤 재질이나 배송 모두 만족합니다	입구/NNG 가/JKS 조금/MAG 좁/VA 은/ETM 것/NNB 말/VV 고/EC ㄴ/JX 재질/NNG 이나/JC 배송/NNG 모두/MAG 만족/NNG 하/XSA ㅂ니다/EF
배송느림.. 레깅스 밑단 마무리 엉성함.. 수트화면보다 밝음..주황색같아요	배송/NNG 느리/VA ㅁ/EF ../SF 레깅스/NNG 밑/NNG 단/NNG 마무리/NNG 엉성/XR 하/XSA ㅁ/EF ../SF 수트/NNG 화면/NNG 보다/JKB 밝/VA 음/EF ../SF 주황색/NNG 같/VA 아요/EF
빠른배송감사합니다. 역시 헤라가 짱입니다~^^	빠르/VA ㄴ/ETM 배송/NNG 감사/NNG 하/XSV ㅂ니다/EF ./SF 역시/MAG 헤라/NNP 가/JKS 짱/NNG 이/VCP ㅂ니다/EF ~/SO ^^/SW
여기진짜맛있어요ㅜㅠ	여기/NP 진짜/MAG 맛있/VA 어요/EF ㅜㅠ/SW
좀 구겨져서 왔는데 귀찮아서 그냥 써요	좀/MAG 구겨지/VV 어서/EC 오/VV 았/EP 는데/EC 귀찮/VA 아서/EC 그냥/MAG 쓰/VV 어요/EF
MB_OK 상수 때문에 MessageBox 함수 쓰기가 껄끄러운 분들은 #define MB_OUT MB_OK 를 쓰세요. 이런것도 테크닉입니다.ㅎ 디씨의 뭐시기뭐시기횽 말씀 인용.	MB_OK/SL 상수/NNG 때문/NNB 에/JKB MessageBox/SL 함수/NNG 쓰/VV 기/ETN 가/JKS 껄끄럽/VA ㄴ/ETM 분/NNB 들/XSN 은/JX #define/W_HASHTAG MB_OUT/SL MB_OK/SL 를/JKO 쓰/VV 세요/EF ./SF 이런/MM 것/NNB 도/JX 테크닉/NNG 이/VCP ㅂ니다/EF ./SF ㅎ/SW 디씨/NNP 의/JKG 뭐시기뭐시기/NNP 횽/XSN 말씀/NNG 인용/NNG ./SF
*탄소 순환: 동물은 호흡뿐만 아니라, 죽은 후에 썩으면서(미생물에 의한 작용)도 탄소방출. 미생물이 없으면 탄소순환의 고리가 끊기게 됨. 탄소 고정은 광합성 식물과 해양 미생물에 의해 이루어진다. -산소 순환은 탄소 순환과 밀접하게 연결되어 있음	*/SW 탄소/NNG 순환/NNG :/SP 동물/NNG 은/JX 호흡/NNG 뿐/JX 만/JX 아니/VCN 라/EC ,/SP 죽/VV 은/ETM 후/NNG 에/JKB 썩/VV 으면서/EC (/SSO 미생물/NNG 에/JKB 의하/VV ㄴ/ETM 작용/NNG )/SSC 도/JX 탄소/NNG 방출/NNG ./SF 미생물/NNG 이/JKS 없/VA 으면/EC 탄소/NNG 순환/NNG 의/JKG 고리/NNG 가/JKS 끊기/VV 게/EC 되/VV ㅁ/EF ./SF 탄소/NNG 고정/NNG 은/JX 광합성/NNG 식물/NNG 과/JC 해양/NNG 미생물/NNG 에/JKB 의하/VV 여/EC 이루/VV 어/EC 지/VX ㄴ다/EF ./SF -/SO 산소/NNG 순환/NNG 은/JX 탄소/NNG 순환/NNG 과/JKB 밀접/NNG 하/XSA 게/EC 연결/NNG 되/XSV 어/EC 있/VX 음/EF
목뿌러진게왔네요... 검수잘해달라고 부탁드렸는데ㅠ	목/NNG 부러지/VV ㄴ/ETM 것/NNB 이/JKS 오/VV 았/EP 네요/EF .../SF 검수/NNG 잘/MAG 하/XSV 여/EC 달/VX 라고/EC 부탁/NNG 드리/VV 었/EP 는데/EC ㅠ/SW
피아노와 피콜로와 스트링 소리가 어우러져 나름 들을만하다고 (그때 작곡한 곡 중에서는 가장 건질만하다고) 판단해서 슬쩍 올려봅니다. 사실 곡 자체가 복잡하거나 긴 게 아니라서 이틀만에 뚝딱뚝딱 만들어냈는데, 그런것 치고는 들을만 해서 아직까지 남겨두고 있습니다.	피아노/NNG 와/JC 피콜로/NNG 와/JC 스트링/NNG 소리/NNG 가/JKS 어우러지/VV 어/EC 나름/MAG 듣/VV 을/ETM 만/NNB 하/XSA 다고/EC (/SSO 그/MM 때/NNG 작곡/NNG 하/XSV ㄴ/ETM 곡/NNG 중/NNB 에서/JKB 는/JX 가장/MAG 건지/VV ᆯ/ETM 만/NNB 하/XSA 다고/EC )/SSC 판단/NNG 하/XSV 여서/EC 슬쩍/MAG 올리/VV 어/EC 보/VX ᆸ니다/EF ./SF 사실/MAG 곡/NNG 자체/NNG 가/JKS 복잡/XR 하/XSA 거나/EC 길/VA ㄴ/ETM 것/NNB 이/JKC 아니/VCN 라서/EC 이틀/NNG 만/NNB 에/JKB 뚝딱뚝딱/MAG 만들/VV 어/EC 내/VX 었/EP 는데/EC ,/SP 그런/MM 것/NNB 치/VV 고는/EC 듣/VV 을/ETM 만/NNB 하/VV 여서/EC 아직/MAG 까지/JX 남기/VV 어/EC 두/VX 고/EC 있/VX 습니다/EF ./SF
상품포장이 바뀐건가요?	상품/NNG 포장/NNG 이/JKS 바뀌/VV ㄴ/ETM 것/NNB 이/VCP ㄴ가요/EF ?/SF
작업하기까다로움 효과도 체감안됨	작업/NNG 하/XSV 기/ETN 까다롭/VA ㅁ/EF 효과/NNG 도/JX 체감/NNG 안/MAG 되/VV ㅁ/EF
배송이 빨랏어요. 매번 먹단거랑 싼가격에 빨리 샀어요... 빠른배성 감사합니다	배송/NNG 이/JKS 빠르/VA 엇/EP 어요/EF ./SF 매번/MAG 먹/VV 단/ETM 거/NNB 랑/JKB 싸/VA ㄴ/ETM 가격/NNG 에/JKB 빨리/MAG 사/VV 았/EP 어요/EF .../SF 빠르/VA ㄴ/ETM 배송/NNG 감사/NNG 하/XSV ㅂ니다/EF
10일만에 배송되어 너무 오래 기다려 별 1개 뺐어요. 유효기간도 2023년까지라 좋고 포장도 꼼꼼하게 잘 되어 왔네요~	10/SN 일/NNB 만/NNB 에/JKB 배송/NNG 되/XSV 어/EC 너무/MAG 오래/MAG 기다리/VV 어/EC 별/NNG 1/SN 개/NNB 빼/VV 었/EP 어요/EF ./SF 유효/NNG 기간/NNG 도/JX 2023/SN 년/NNB 까지/JX 이/VCP 라/EC 좋/VA 고/EC 포장/NNG 도/JX 꼼꼼/XR 하/XSA 게/EC 잘/MAG 되/VV 어/EC 오/VX 았/EP 네요/EF ~/SO
처음에받았을땐 너무튼튼하구 칸막이도있구 너무맘에들었는데요... 지금도맘에는들어요..근데....먼지가 먼지가 세상먼지다묻어요ㅠㅠ흑흑ㅠ 집에가만히 뒀는데도 먼지가다묻어있어요ㅠ 한번들고 그냥 모셔두었어요ㅜㅜ 까만색은 넘나비추입니다ㅠ 아이보리로살껄...ㅠ	처음/NNG 에/JKB 받/VV 았/EP 을/ETM 때/NNG ㄴ/JX 너무/MAG 튼튼/XR 하/XSA 구/EC 칸막이/NNG 도/JX 있/VA 구/EC 너무/MAG 맘/NNG 에/JKB 들/VV 었/EP 는데요/EF .../SF 지금/NNG 도/JX 맘/NNG 에/JKB 는/JX 들/VV 어요/EF ../SF 근데/MAJ ..../SF 먼지/NNG 가/JKS 먼지/NNG 가/JKS 세상/NNG 먼지/NNG 다/MAG 묻/VV 어요/EF ㅠㅠ/SW 흑흑/IC ㅠ/SW 집/NNG 에/JKB 가만히/MAG 두/VV 었/EP 는데/EC 도/JX 먼지/NNG 가/JKS 다/MAG 묻/VV 어/EC 있/VX 어요/EF ㅠ/SW 한번/MAG 들/VV 고/EC 그냥/MAG 모시/VV 어/EC 두/VX 었/EP 어요/EF ㅜㅜ/SW 까만색/NNG 은/JX 넘나/MAG 비추/NNG 이/VCP ㅂ니다/EF ㅠ/SW 아이보리/NNG 로/JKB 살/VV ᆯ/ETM 꺼/NNB ᆯ/JKO .../SF ㅠ/SW
재구매 잘먹고있습니다 아침식사로좋아요	재/XPN 구매/NNG 잘/MAG 먹/VV 고/EC 있/VX 습니다/EF 아침/NNG 식사/NNG 로/JKB 좋/VA 아요/EF
어이가없네요 셈플한개가 비어서 왔네요	어이/NNG 가/JKS 없/VA 네요/EF 샘플/NNG 한/MM 개/NNB 가/JKS 비/VV 어서/EC 오/VV 았/EP 네요/EF
밑바탕으로 사용할 BERT 모델은 2가지를 준비해보았습니다. 첫번째는 구글에서 학습시킨 bert-base-multilingual-cased 모델입니다. 이는 다국어 데이터에 대해 학습한 것으로 한국어 전용 모델은 아니지만, 한국어에 대해서도 어느 정도 잘 작동한다고 알려져 있습니다.	밑바탕/NNG 으로/JKB 사용/NNG 하/XSV ㄹ/ETM BERT/SL 모델/NNG 은/JX 2/SN 가지/NNB 를/JKO 준비/NNG 하/XSV 여/EC 보/VX 았/EP 습니다/EF ./SF 첫/MM 번째/NNB 는/JX 구글/NNP 에서/JKB 학습/NNG 시키/XSV ㄴ/ETM bert/SL -/SO base/SL -/SO multilingual/SL -/SO cased/SL 모델/NNG 이/VCP ㅂ니다/EF ./SF 이/NP 는/JX 다국어/NNG 데이터/NNG 에/JKB 대하/VV 여/EC 학습/NNG 하/XSV ㄴ/ETM 것/NNB 으로/JKB 한국어/NNP 전용/NNG 모델/NNG 은/JX 아니/VCN 지만/EC ,/SP 한국어/NNP 에/JKB 대하/VV 여서/EC 도/JX 어느/MM 정도/NNG 잘/MAG 작동/NNG 하/XSV ㄴ다고/EC 알리/VV 어/EC 지/VX 어/EC 있/VX 습니다/EF ./SF
컴퓨터에게 인공지능을 불어넣는것은 참으로 귀찮고 어려운 작업입니다. 그런데 스타2 캠페인을 하다보면 참 맵 제작자로서는 존경스러울 정도로 인공지능을 잘 넣어놨지요.	컴퓨터/NNG 에게/JKB 인공/NNG 지능/NNG 을/JKO 불어넣/VV 는/ETM 것/NNB 은/JX 참으로/MAG 귀찮/VA 고/EC 어렵/VA ㄴ/ETM 작업/NNG 이/VCP ㅂ니다/EF ./SF 그런데/MAJ 스타/NNG 2/SN 캠페인/NNG 을/JKO 하/VV 다/EC 보/VX 면/EC 참/MAG 맵/NNG 제작자/NNG 로서/JKB 는/JX 존경/NNG 스럽/XSA ㄹ/ETM 정도/NNG 로/JKB 인공/NNG 지능/NNG 을/JKO 잘/MAG 넣/VV 어/EC 놓/VX 았/EP 지요/EF ./SF
만족해요 싸게 잘 산듯	만족/NNG 하/XSA 여요/EF 싸/VA 게/EC 잘/MAG 사/VV ㄴ/ETM 듯/EC
신선하고 너무맛있어요!^^	신선/XR 하/XSA 고/EC 너무/MAG 맛있/VA 어요/EF !/SF ^^/SW
‘ 발송완료로 잡아놓고 늦게보내네요 취소할까봐그런지는몰라도 기분나쁘네요 다음엔 안시킬거같아요 여기선	‘/SSO 발송/NNG 완료/NNG 로/JKB 잡/VV 아/EC 놓/VX 고/EC 늦/VA 게/EC 보내/VV 네요/EF 취소/NNG 하/XSV ㄹ까/EC 보/VX 어/EC 그렇/VA ㄴ지/EC 는/JX 모르/VV 아도/EC 기분/NNG 나쁘/VA 네요/EF 다음/NNG 에/JKB ㄴ/JX 안/MAG 시키/VV ᆯ/ETM 거/NNB 같/VA 아요/EF 여기/NP 서/JKB ㄴ/JX
재구매 좋아요 잘받았습니다 잘쓸께요	재/XPN 구매/NNG 좋/VA 아요/EF 잘/MAG 받/VV 았/EP 습니다/EF 잘/MAG 쓰/VV ᆯ께요/EF
쓸데가 하나없음 효과일도없음	쓸데/NNG 가/JKS 하나/NR 없/VA 음/EF 효과/NNG 일/NNG 도/JX 없/VA 음/EF
배송빠름 세개중 하나는 새서 양이 적음^^	배송/NNG 빠르/VA ㅁ/EF 세/MM 개/NNB 중/NNB 하나/NR 는/JX 새/VV 어서/EC 양/NNG 이/JKS 적/VA 음/EF ^^/SW
좋아요 ㅎ 벤치들때쓰려고샀어ㆍ오	좋/VA 아요/EF ㅎ/SW 벤치/NNG 들/VV ㄹ/ETM 때/NNG 쓰/VV 려고/EC 사/VV 았/EP 어ㆍ오/EF
연어초밥, 연어장 만들어 먹었는데 너무 맛있어요! 내일은 연어 스테이크랑 까나페 해먹으려고합니다	연어/NNG 초밥/NNG ,/SP 연어장/NNG 만들/VV 어/EC 먹/VV 었/EP 는데/EC 너무/MAG 맛있/VA 어요/EF !/SF 내일/NNG 은/JX 연어/NNG 스테이크/NNG 랑/JC 까나페/NNG 하/VV 여/EC 먹/VX 으려고/EC 하/VX ㅂ니다/EF
저렴하게 받아서 기분은좋아요 근데 가방에 실리콘 같은게 좀 묻어있더라구요.. 그거말고는 괜찬은거같아요	저렴/XR 하/XSA 게/EC 받/VV 아서/EC 기분/NNG 은/JX 좋/VA 아요/EF 근데/MAJ 가방/NNG 에/JKB 실리콘/NNG 같/VA 은/ETM 것/NNB 이/JKS 좀/MAG 묻/VV 어/EC 있/VX 더라구요/EF ../SF 그거/NP 말/VV 고/EC 는/JX 괜찬/VA 은/ETM 것/NNB 같/VA 아요/EF
급해서 쓰기는 했지만 정말 거지같네요 왜 엉뚱한 회색을 보냈는지요?	급하/VA 여서/EC 쓰/VV 기/ETN 는/JX 하/VX 였/EP 지만/EC 정말/MAG 거지/NNG 같/VA 네요/EF 왜/MAG 엉뚱/XR 하/XSA ㄴ/ETM 회색/NNG 을/JKO 보내/VV 었/EP 는지요/EF ?/SF
이건아님 다죽어서 오고 생물삿는데 죽어서 먹기 찝찝해요 어찌한마리도 안살아 잇을수가ㅠㅠ 진짜후기보고삿는데 의심가네요	이거/NP ᆫ/JX 아니/VCN ㅁ/ETN 다/MAG 죽/VV 어서/EC 오/VV 고/EC 생물/NNG 사/VV 엇/EP 는데/EC 죽/VV 어서/EC 먹/VV 기/ETN 찝찝/XR 하/XSA 여요/EF 어찌/MAG 한/MM 마리/NNB 도/JX 안/MAG 살/VV 아/EC 잇/VV 을/ETM 수/NNB 가/JKS ㅠㅠ/SW 진짜/MAG 후기/NNG 보/VV 고/EC 사/VV 엇/EP 는데/EC 의심/NNG 가/VV 네요/EF
집에서 입으려고 샀는데 색깔은 사진과 달라서 교환할까 하다 그냥 입으려구요.	집/NNG 에서/JKB 입/VV 으려고/EC 사/VV 았/EP 는데/EC 색깔/NNG 은/JX 사진/NNG 과/JKB 다르/VA 아서/EC 교환/NNG 하/XSV ㄹ까/EC 하/VV 다/EC 그냥/MAG 입/VV 으려구요/EF ./SF
주문하고 그다음날 배송 받았어요 프리퀀시 다 해서 받고 싶은데 갈때마다 없어서 그냥 인터넷 구매 했네요ㅜ 받고 보니 역시 이뻐용	주문/NNG 하/XSV 고/EC 그/MM 다음날/NNG 배송/NNG 받/VV 았/EP 어요/EF 프리퀀시/NNP 다/MAG 하/VV 여서/EC 받/VV 고/EC 싶/VX 은데/EC 가/VV ㄹ/ETM 때/NNG 마다/JX 없/VA 어서/EC 그냥/MAG 인터넷/NNG 구매/NNG 하/VV 였/EP 네요/EF ㅜ/SW 받/VV 고/EC 보/VX 니/EC 역시/MAG 이쁘/VA 어용/EF
어릴때먹어본기억이있어서 한번사봤어요. 제가 먹어봤던 그맛이 맞는건진 모르겠는데..? 신선한건좋은데 새콤달콤한맛이있는거같으면서 맹맛같기도하고 약간 떫은거같아요.	어리/VA ㄹ/ETM 때/NNG 먹/VV 어/EC 보/VX ᆫ/ETM 기억/NNG 이/JKS 있/VA 어서/EC 한/MM 번/NNB 사/VV 아/EC 보/VX 았/EP 어요/EF ./SF 저/NP 가/JKS 먹/VV 어/EC 보/VX 았/EP 던/ETM 그/MM 맛/NNG 이/JKS 맞/VV 는/ETM 것/NNB 이/VCP ㄴ지/EC ㄴ/JX 모르/VV 겠/EP 는데/EF ..?/SF 신선/XR 하/XSA ᆫ/ETM 거/NNB ᆫ/JX 좋/VA 은데/EC 새콤/XR 달콤/XR 하/XSA ㄴ/ETM 맛/NNG 이/JKS 있/VA 는/ETM 것/NNB 같/VA 으면서/EC 맹/XPN 맛/NNG 같/VA 기/ETN 도/JX 하/VX 고/EC 약간/MAG 떫/VA 은/ETM 것/NNB 같/VA 아요/EF ./SF
이 예쁜 꽃은 독을 품었지만 진짜 아름다움을 가지고 있어요.	이/MM 예쁘/VA ㄴ/ETM 꽃/NNG 은/JX 독/NNG 을/JKO 품/VV 었/EP 지만/EC 진짜/MAG 아름다움/NNG 을/JKO 가지/VV 고/EC 있/VX 어요/EF ./SF
가성비최고입니다 색도예뻐요.	가성비/NNG 최고/NNG 이/VCP ㅂ니다/EF 색/NNG 도/JX 예쁘/VA 어요/EF ./SF
먼지가 잘 안 붙을 것 같은 재질인데 마감이 별로라 어떻게끼워도 삐뚤합니다. 싼맛에 하겠지만 다음엔 구매하지 않을 것 같아요	먼지/NNG 가/JKS 잘/MAG 안/MAG 붙/VV 을/ETM 것/NNB 같/VA 은/ETM 재질/NNG 이/VCP ㄴ데/EC 마감/NNG 이/JKS 별로/MAG 이/VCP 라/EC 어떻/VA 게/EC 끼우/VV 어도/EC 삐뚤/MAG 하/XSA ㅂ니다/EF ./SF 싸/VA ᆫ/ETM 맛/NNG 에/JKB 하/VV 겠/EP 지만/EC 다음/NNG 에/JKB ㄴ/JX 구매/NNG 하/XSV 지/EC 않/VX 을/ETM 것/NNB 같/VA 아요/EF
텍스트의 긍정과 부정을 분류한다는건 생각보다 까다로운 일입니다. 사람들이 특정 대상에 대해 긍정 혹은 부정 감정을 드러낼때 직설적으로 좋다/나쁘다고 표현하는 경우도 있지만, 우회적으로 이야기하거나, 비유를 들거나, 비꼬는 경우도 많기 때문이죠.	텍스트/NNG 의/JKG 긍정/NNG 과/JC 부정/NNG 을/JKO 분류/NNG 하/XSV ㄴ다는/ETM 것/NNB ㄴ/JX 생각/NNG 보다/JKB 까다롭/VA ㄴ/ETM 일/NNG 이/VCP ㅂ니다/EF ./SF 사람/NNG 들/XSN 이/JKS 특정/NNG 대상/NNG 에/JKB 대하/VV 여/EC 긍정/NNG 혹은/MAG 부정/NNG 감정/NNG 을/JKO 드러내/VV ㄹ/ETM 때/NNG 직설/NNG 적/XSN 으로/JKB 좋/VA 다/EC //SP 나쁘/VA 다고/EC 표현/NNG 하/XSV 는/ETM 경우/NNG 도/JX 있/VA 지만/EC ,/SP 우회/NNG 적/XSN 으로/JKB 이야기/NNG 하/XSV 거나/EC ,/SP 비유/NNG 를/JKO 들/VV 거나/EC ,/SP 비꼬/VV 는/ETM 경우/NNG 도/JX 많/VA 기/ETN 때문/NNB 이/VCP 죠/EF ./SF
제품에 하자는 없으나...기대가 너무 컸나봐요... 별로 맛은 없네요....	제품/NNG 에/JKB 하자/NNG 는/JX 없/VA 으나/EC .../SF 기대/NNG 가/JKS 너무/MAG 크/VA 었/EP 나/EC 보/VX 아요/EF .../SF 별로/MAG 맛/NNG 은/JX 없/VA 네요/EF ..../SF
*매독 Syphilis: 예방 치료가 가능한 질병. 증상이 명확하게 드러남. 임신 중 아이에게 전염될 수 있기때문에, 아이를 가지면 안됨. 1기, 2기 단계에서는 페니실린을 이용해 치료가능. 3기에 이르게 되면 온몸의 장기로 병이 전염되어 위험해짐	*/SW 매독/NNG Syphilis/SL :/SP 예방/NNG 치료/NNG 가/JKS 가능/NNG 하/XSA ㄴ/ETM 질병/NNG ./SF 증상/NNG 이/JKS 명확/XR 하/XSA 게/EC 드러나/VV ㅁ/EF ./SF 임신/NNG 중/NNB 아이/NNG 에게/JKB 전염/NNG 되/XSV ㄹ/ETM 수/NNB 있/VA 기/ETN 때문/NNB 에/JKB ,/SP 아이/NNG 를/JKO 가지/VV 면/EC 안/MAG 되/VV ㅁ/EF ./SF 1/SN 기/NNG ,/SP 2/SN 기/NNG 단계/NNG 에서/JKB 는/JX 페니실린/NNG 을/JKO 이용/NNG 하/XSV 여/EC 치료/NNG 가능/NNG ./SF 3/SN 기/NNG 에/JKB 이르/VV 게/EC 되/VV 면/EC 온/XPN 몸/NNG 의/JKG 장기/NNG 로/JKB 병/NNG 이/JKS 전염/NNG 되/XSV 어/EC 위험/NNG 하/XSA 어/EC 지/VX ㅁ/EF
고전 라틴어 시기에는 수많은 문학가들이 등장해, 라틴어 문학의 황금기를 이루었습니다. 익히 들으면 알법한 로마 작가/정치인들은 거의 이 시기 사람들이라고 생각하면 됩니다.	고전/NNG 라틴어/NNP 시기/NNG 에/JKB 는/JX 수많/VA 은/ETM 문학가/NNG 들/XSN 이/JKS 등장/NNG 하/XSV 여/EC ,/SP 라틴어/NNP 문학/NNG 의/JKG 황금기/NNG 를/JKO 이루/VV 었/EP 습니다/EF ./SF 익히/MAG 듣/VV 으면/EC 알/VV ᆯ/ETM 법/NNB 하/XSA ㄴ/ETM 로마/NNP 작가/NNG //SP 정치인/NNG 들/XSN 은/JX 거의/MAG 이/MM 시기/NNG 사람/NNG 들/XSN 이/VCP 라고/EC 생각/NNG 하/XSV 면/EC 되/VV ㅂ니다/EF ./SF
착오로 인한 오배송건을 친절하게 상담해주시고 신속하게 재배송해주셨네요 상품의 빠른 배송과 훌륭한 품질이 아주 만족스런 거래였습니다	착오/NNG 로/JKB 인하/VV ㄴ/ETM 오배송/NNG 건/NNB 을/JKO 친절/NNG 하/XSA 게/EC 상담/NNG 하/XSV 여/EC 주/VX 시/EP 고/EC 신속/NNG 하/XSA 게/EC 재/XPN 배송/NNG 하/XSV 여/EC 주/VX 시/EP 었/EP 네요/EF 상품/NNG 의/JKG 빠르/VA ㄴ/ETM 배송/NNG 과/JC 훌륭/XR 하/XSA ㄴ/ETM 품질/NNG 이/JKS 아주/MAG 만족/NNG 스럽/XSA ㄴ/ETM 거래/NNG 이/VCP 었/EP 습니다/EF
건물을 필요한 지점에 딱딱 짓는다던가 적절할 때 유닛을 생산한다던가 대게 이런 일들은 트리거의 행동 [지시 전달]을 통해서 만들수 있지만, 삽질의 연속이라 할 수 있습니다.	건물/NNG 을/JKO 필요/NNG 하/XSA ㄴ/ETM 지점/NNG 에/JKB 딱딱/MAG 짓/VV 는다던가/EC 적절/XR 하/XSA ㄹ/ETM 때/NNG 유닛/NNG 을/JKO 생산/NNG 하/XSV ㄴ다던가/EC 대게/MAG 이런/MM 일/NNG 들/XSN 은/JX 트리거/NNG 의/JKG 행동/NNG [/SSO 지시/NNG 전달/NNG ]/SSC 을/JKO 통하/VV 여서/EC 만들/VV ㄹ/ETM 수/NNB 있/VA 지만/EC ,/SP 삽/NNG 질/XSN 의/JKG 연속/NNG 이/VCP 라/EC 하/VV ㄹ/ETM 수/NNB 있/VA 습니다/EF ./SF
"빨리 가려면 혼자 가고, 멀리 가려면 함께 가라" 이 문장의 운율을 살려서 작문 가능할까요?	"/SSO 빨리/MAG 가/VV 려면/EC 혼자/MAG 가/VV 고/EC ,/SP 멀리/MAG 가/VV 려면/EC 함께/MAG 가/VV 라/EF "/SSC 이/MM 문장/NNG 의/JKG 운율/NNG 을/JKO 살리/VV 어서/EC 작문/NNG 가능/NNG 하/XSA ㄹ까요/EF ?/SF
최근 카톨릭에서 새 교황이 선출되었습니다. 교황 선출하면 늘 떠오르는게 Tu es petrus라는 노래입니다.	최근/MAG 카톨릭/NNG 에서/JKB 새/MM 교황/NNG 이/JKS 선출/NNG 되/XSV 었/EP 습니다/EF ./SF 교황/NNG 선출/NNG 하/XSV 면/EC 늘/MAG 떠오르/VV 는/ETM 것/NNB 이/JKS Tu/SL es/SL petrus/SL 이/VCP 라는/ETM 노래/NNG 이/VCP ㅂ니다/EF ./SF
만족합니다. 슬림핏 아닌 레귤러네요	만족/NNG 하/XSA ㅂ니다/EF ./SF 슬림핏/NNG 아니/VCN ㄴ/ETM 레귤러/NNG 이/VCP 네요/EF
(사실 호텔 데이터도 수집했었는데, 워낙 개수가 적어서 동등한 비교가 어려울거 같아 제외했습니다. 나중에 데이터가 충분히 모이면 호텔 데이터 실험도 추가하겠습니다~.)	(/SSO 사실/MAG 호텔/NNG 데이터/NNG 도/JX 수집/NNG 하/XSV 였었/EP 는데/EC ,/SP 워낙/MAG 개수/NNG 가/JKS 적/VA 어서/EC 동등/NNG 하/XSA ㄴ/ETM 비교/NNG 가/JKS 어렵/VA 을/ETM 거/NNB 같/VA 아/EC 제외/NNG 하/XSV 였/EP 습니다/EF ./SF 나중/NNG 에/JKB 데이터/NNG 가/JKS 충분히/MAG 모이/VV 면/EC 호텔/NNG 데이터/NNG 실험/NNG 도/JX 추가/NNG 하/XSV 겠/EP 습니다/EC ~/SO ./SF )/SSC
핀부분만 골드라서그런지 이쁘긴한데 알러지반응이 있네요ㅠㅠ	핀/NNG 부분/NNG 만/JX 골드/NNG 이/VCP 라서/EC 그렇/VA ㄴ지/EC 이쁘/VA 기/ETN ᆫ/JX 하/VX ㄴ데/EC 알러지/NNG 반응/NNG 이/JKS 있/VA 네요/EF ㅠㅠ/SW
금지 명령을 둘 이상 연결하기 위해서는 et을 사용할 수 없습니다. 첫번째 명령문이 ne(혹은 nemo, nihil, nullus 등)를 사용한 금지 명령이고, 다음 문장으로 또 다른 금지 명령이 뒤따르는 경우에는 neve나 neu를 사용하여 연결하여야 합니다.	금지/NNG 명령/NNG 을/JKO 둘/NR 이상/NNG 연결/NNG 하/XSV 기/ETN 위하/VV 여서/EC 는/JX et/SL 을/JKO 사용/NNG 하/XSV ㄹ/ETM 수/NNB 없/VA 습니다/EF ./SF 첫/MM 번째/NNB 명령문/NNG 이/JKS ne/SL (/SSO 혹은/MAJ nemo/SL ,/SP nihil/SL ,/SP nullus/SL 등/NNB )/SSC 를/JKO 사용/NNG 하/XSV ㄴ/ETM 금지/NNG 명령/NNG 이/VCP 고/EC ,/SP 다음/NNG 문장/NNG 으로/JKB 또/MAG 다른/MM 금지/NNG 명령/NNG 이/JKS 뒤따르/VV 는/ETM 경우/NNG 에/JKB 는/JX neve/SL 나/JC neu/SL 를/JKO 사용/NNG 하/XSV 여/EC 연결/NNG 하/XSV 여야/EC 하/VX ㅂ니다/EF ./SF
이 가정(사전 확률, prior)에 입각한 상태에서 각 문헌에서 실제 토픽과 그 토픽에 속하는 단어가 발견되면 이를 바탕으로 각 문헌별 토픽 출현 확률을 더 정확하게 개선(사후 확률, posterior)합니다.	이/MM 가정/NNG (/SSO 사전/NNG 확률/NNG ,/SP prior/SL )/SSC 에/JKB 입각/NNG 하/XSV ㄴ/ETM 상태/NNG 에서/JKB 각/MM 문헌/NNG 에서/JKB 실제/NNG 토픽/NNG 과/JC 그/MM 토픽/NNG 에/JKB 속하/VV 는/ETM 단어/NNG 가/JKS 발견/NNG 되/XSV 면/EC 이/NP 를/JKO 바탕/NNG 으로/JKB 각/MM 문헌/NNG 별/XSN 토픽/NNG 출현/NNG 확률/NNG 을/JKO 더/MAG 정확/XR 하/XSA 게/EC 개선/NNG (/SSO 사후/NNG 확률/NNG ,/SP posterior/SL )/SSC 하/XSV ㅂ니다/EF ./SF
배송하루 더걸렸지만..늘 감사히먹고있습니다	배송/NNG 하루/NNG 더/MAG 걸리/VV 었/EP 지만/EF ../SF 늘/MAG 감사히/MAG 먹/VV 고/EC 있/VX 습니다/EF
상판이 조금 약하긴한데 일부러 누르지 않는한 크고 좋아요.	상판/NNG 이/JKS 조금/MAG 약하/VA 기/ETN ᆫ/JX 하/VX ㄴ데/EC 일부러/MAG 누르/VV 지/EC 않/VX 는/ETM 한/NNB 크/VA 고/EC 좋/VA 아요/EF ./SF
오리온 베이지 설치했습니다, 색상이 미색이 아니라 엘로우에 가깝습니다.	오리온/NNP 베이지/NNG 설치/NNG 하/XSV 였/EP 습니다/EC ,/SP 색상/NNG 이/JKS 미색/NNG 이/JKC 아니/VCN 라/EC 엘로우/NNG 에/JKB 가깝/VA 습니다/EF ./SF
MIDI를 이용한 리듬 게임을 위해서 만들던 midi를 wave로 변환해주는 엔진이 그럴싸해졌다.	MIDI/SL 를/JKO 이용/NNG 하/XSV ㄴ/ETM 리듬/NNG 게임/NNG 을/JKO 위하/VV 여서/EC 만들/VV 던/ETM midi/SL 를/JKO wave/SL 로/JKB 변환/NNG 하/XSV 여/EC 주/VX 는/ETM 엔진/NNG 이/JKS 그럴싸하/VA 여/EC 지/VX 었/EP 다/EF ./SF
가격대비 별로에요!!	가격/NNG 대비/NNG 별로/MAG 이/VCP 에요/EF !!/SF
믿고쓰는 페넬로페^^ 세자린쓰다가 새로 나온 제품이라서 구매했어요ㅎㅎ 세자린 마지막 팩쓰고 있는데, 떨어지기 전에 도착했네요^^	믿/VV 고/EC 쓰/VV 는/ETM 페넬로페/NNP ^^/SW 세자린/NNP 쓰/VV 다가/EC 새로/MAG 나오/VV ㄴ/ETM 제품/NNG 이/VCP 라서/EC 구매/NNG 하/XSV 였/EP 어요/EF ㅎㅎ/SW 세자린/NNP 마지막/NNG 팩/NNG 쓰/VV 고/EC 있/VX 는데/EC ,/SP 떨어지/VV 기/ETN 전/NNG 에/JKB 도착/NNG 하/XSV 였/EP 네요/EF ^^/SW
유통기한이 제조일로부터 18개월이라는데 제조일은 도대체 어디다 쓰신건가요?	유통/NNG 기한/NNG 이/JKS 제조/NNG 일/NNG 로부터/JKB 18/SN 개월/NNB 이/VCP 라는데/EC 제조/NNG 일/NNG 은/JX 도대체/MAG 어디/NP 다/JX 쓰/VV 시/EP ㄴ/ETM 것/NNB 이/VCP ㄴ가요/EF ?/SF
세번째 액정 자가수리한 사람입니다. 살살 다루기도하고 영상보고 따라할정도로 총작업시간 1시간가량 걸렸습니다. 다른곳 이상 하나도 없습니다 다만 홈버튼이 전혀 반응하지않고있습니다 커넥터의 문제인지 제문제인지 모르겠으나 세번째만에 처음 발생한 일입니다.	세/MM 번째/NNB 액정/NNG 자가/NNG 수리/NNG 하/XSV ㄴ/ETM 사람/NNG 이/VCP ㅂ니다/EF ./SF 살살/MAG 다루/VV 기/ETN 도/JX 하/VX 고/EC 영상/NNG 보/VV 고/EC 따라하/VV ㄹ/ETM 정도/NNG 로/JKB 총작업/NNG 시간/NNG 1/SN 시간/NNB 가량/XSN 걸리/VV 었/EP 습니다/EF ./SF 다른/MM 곳/NNG 이상/NNG 하나/NR 도/JX 없/VA 습니다/EF 다만/MAG 홈/NNG 버튼/NNG 이/JKS 전혀/MAG 반응/NNG 하/XSV 지/EC 않/VX 고/EC 있/VX 습니다/EF 커넥터/NNG 의/JKG 문제/NNG 이/VCP ㄴ지/EC 저/NP 의/JKG 문제/NNG 이/VCP ㄴ지/EC 모르/VV 겠/EP 으나/EC 세/MM 번째/NNB 만/NNB 에/JKB 처음/NNG 발생/NNG 하/XSV ㄴ/ETM 일/NNG 이/VCP ㅂ니다/EF ./SF
즉, 특정 문헌에서 각 어떤 토픽이 생성될지 잘 모르므로, 일단 모든 문헌에서 각 토픽이 발생할 확률을 동일하게 가정합니다.	즉/MAG ,/SP 특정/NNG 문헌/NNG 에서/JKB 각/MM 어떤/MM 토픽/NNG 이/JKS 생성/NNG 되/XSV ㄹ지/EC 잘/MAG 모르/VV 므로/EC ,/SP 일단/MAG 모든/MM 문헌/NNG 에서/JKB 각/MM 토픽/NNG 이/JKS 발생/NNG 하/XSV ㄹ/ETM 확률/NNG 을/JKO 동일/NNG 하/XSA 게/EC 가정/NNG 하/XSV ㅂ니다/EF ./SF
머리결은 트리트먼트 오래한거 치고는 그냥그럼, 탈색을 하지 않은 밝은 갈색모인데 파란색이 전혀 안입혀짐	머리결/NNG 은/JX 트리트먼트/NNG 오래/MAG 하/XSV ㄴ/ETM 거/NNB 치/VV 고는/EC 그냥/MAG 그렇/VA ㅁ/EF ,/SP 탈색/NNG 을/JKO 하/VV 지/EC 않/VX 은/ETM 밝/VA 은/ETM 갈색/NNG 모/NNG 이/VCP ㄴ데/EC 파란색/NNG 이/JKS 전혀/MAG 안/MAG 입히/VV 어/EC 지/VX ㅁ/EF
안경 크기도 딱 원했던 만큼이고 가볍고 좋습니다👍	안경/NNG 크기/NNG 도/JX 딱/MAG 원하/VV 였/EP 던/ETM 만큼/NNB 이/VCP 고/EC 가볍/VA 고/EC 좋/VA 습니다/EF 👍/SW
기존 써왔던 실크모보다 벨벳모가 훨씬 더 부들부들해서 진짜 속눈썹같고 가볍고 좋아요~~~^^	기존/NNG 쓰/VV 어/EC 오/VX 았/EP 던/ETM 실크모/NNG 보다/JKB 벨벳모/NNG 가/JKS 훨씬/MAG 더/MAG 부들부들/MAG 하/XSA 아서/EC 진짜/MAG 속눈썹/NNG 같/VA 고/EC 가볍/VA 고/EC 좋/VA 아요/EF ~~~/SO ^^/SW
두번째는 SKTBrain에서 학습시킨 KoBERT 모델입니다. 공개된 한국어 BERT 모델 중 가장 접근하기가 쉬워 선택했으며, 구글의 bert-base-multilingual-cased와 모델 크기는 동일하지만, 한국어 성능은 구글 껄 앞선다고 알려져 있습니다.	두/MM 번째/NNB 는/JX SKTBrain/SL 에서/JKB 학습/NNG 시키/XSV ㄴ/ETM KoBERT/SL 모델/NNG 이/VCP ㅂ니다/EF ./SF 공개/NNG 되/XSV ㄴ/ETM 한국어/NNP BERT/SL 모델/NNG 중/NNB 가장/MAG 접근/NNG 하/XSV 기/ETN 가/JKS 쉽/VA 어/EC 선택/NNG 하/XSV 였/EP 으며/EC ,/SP 구글/NNP 의/JKG bert/SL -/SO base/SL -/SO multilingual/SL -/SO cased/SL 와/JC 모델/NNG 크기/NNG 는/JX 동일/NNG 하/XSA 지만/EC ,/SP 한국어/NNP 성능/NNG 은/JX 구글/NNP 꺼/NNB ᆯ/JKO 앞서/VV ㄴ다고/EC 알리/VV 어/EC 지/VX 어/EC 있/VX 습니다/EF ./SF
이런 우회적인 표현 방법은 같은 언어라할지라도 분야에 따라서 크게 달라질 수 있습니다. 그래서 특정 분야에 맞춰 학습시킨 감정 분석 모델은 다른 분야에서는 형편 없는 성능을 보이는 경우가 있습니다.	이런/MM 우회/NNG 적/XSN 이/VCP ㄴ/ETM 표현/NNG 방법/NNG 은/JX 같/VA 은/ETM 언어/NNG 이/VCP 라/EC 하/VV ㄹ지라도/EC 분야/NNG 에/JKB 따르/VV 아서/EC 크/VA 게/EC 달라지/VV ㄹ/ETM 수/NNB 있/VA 습니다/EF ./SF 그래서/MAJ 특정/NNG 분야/NNG 에/JKB 맞추/VV 어/EC 학습/NNG 시키/XSV ㄴ/ETM 감정/NNG 분석/NNG 모델/NNG 은/JX 다른/MM 분야/NNG 에서/JKB 는/JX 형편/NNG 없/VA 는/ETM 성능/NNG 을/JKO 보이/VV 는/ETM 경우/NNG 가/JKS 있/VA 습니다/EF ./SF
사적 소유관계의 변동은 생산력 발달과 그에 따른 생산관계의 모순에 의해 확산조선후기 중세 지주제는 국가의 수조권에 의해 지배되던 외피를 벗으며 발달, 해체.	사/NNG 적/XSN 소유/NNG 관계/NNG 의/JKG 변동/NNG 은/JX 생산/NNG 력/XSN 발달/NNG 과/JC 그/NP 에/JKB 따르/VV ㄴ/ETM 생산/NNG 관계/NNG 의/JKG 모순/NNG 에/JKB 의하/VV 여/EC 확산/NNG 조선/NNP 후기/NNG 중세/NNG 지주/NNG 제/XSN 는/JX 국가/NNG 의/JKG 수조/NNG 권/XSN 에/JKB 의하/VV 여/EC 지배/NNG 되/XSV 던/ETM 외피/NNG 를/JKO 벗/VV 으며/EC 발달/NNG ,/SP 해체/NNG ./SF
배송이 좀 느리고 상자에 제품만들어있네요 사용설명서가없어요 남자는 상관없지만여자분들은난감할수도 있겠네요	배송/NNG 이/JKS 좀/MAG 느리/VA 고/EC 상자/NNG 에/JKB 제품/NNG 만/JX 들/VV 어/EC 있/VX 네요/EF 사용/NNG 설명서/NNG 가/JKS 없/VA 어요/EF 남자/NNG 는/JX 상관없/VA 지만/EC 여자/NNG 분/NNB 들/XSN 은/JX 난감/XR 하/XSA ㄹ/ETM 수/NNB 도/JX 있/VA 겠/EP 네요/EF
받자마자 아이랑 같이 아이스크림 만들어먹었는데 실리콘으로 되어서 빼기도 편하고 좋았어요	받/VV 자마자/EC 아이/NNG 랑/JKB 같이/MAG 아이스크림/NNG 만들/VV 어/EC 먹/VV 었/EP 는데/EC 실리콘/NNG 으로/JKB 되/VV 어서/EC 빼/VV 기/ETN 도/JX 편하/VA 고/EC 좋/VA 았/EP 어요/EF
고전 라틴어(Classic Latin)는 로마 공화정 후기와 로마 제국 때에 사용되었던 라틴어를 일컫는 말입니다.	고전/NNG 라틴어/NNP (/SSO Classic/SL Latin/SL )/SSC 는/JX 로마/NNP 공화정/NNG 후기/NNG 와/JC 로마_제국/NNP 때/NNG 에/JKB 사용/NNG 되/XSV 었/EP 던/ETM 라틴어/NNP 를/JKO 일컫/VV 는/ETM 말/NNG 이/VCP ㅂ니다/EF ./SF
보들보들하고 44사이즈 답게 나왔어요. 잘어울려요	보들보들/MAG 하/XSA 고/EC 44/SN 사이즈/NNG 답/XSA 게/EC 나오/VV 았/EP 어요/EF ./SF 잘/MAG 어울리/VV 어요/EF
비개 가 너--무 많아요	비개/NNG 가/JKS 너--무/MAG 많/VA 아요/EF
화분 연대측정: 토탄 늪이나 호수 침전물 속에 보존된 화분을 이용하여 과거의 식생과 계기순서를 복원하는 방법. 하지만 화분대라는 것이 넓은 지역에 있어 균일하지 않다는 점 때문에, 지역별로 화분대 계기순서가 먼저 확립되어야 상대 편년을 적용할 수 있음.	화분/NNG 연대/NNG 측정/NNG :/SP 토탄/NNG 늪/NNG 이나/JC 호수/NNG 침전물/NNG 속/NNG 에/JKB 보존/NNG 되/XSV ㄴ/ETM 화분/NNG 을/JKO 이용/NNG 하/XSV 여/EC 과거/NNG 의/JKG 식생/NNG 과/JC 계기/NNG 순서/NNG 를/JKO 복원/NNG 하/XSV 는/ETM 방법/NNG ./SF 하지만/MAJ 화분/NNG 대/XSN 이/VCP 라는/ETM 것/NNB 이/JKS 넓/VA 은/ETM 지역/NNG 에/JKB 있/VA 어/EC 균일/NNG 하/XSA 지/EC 않/VX 다는/ETM 점/NNG 때문/NNB 에/JKB ,/SP 지역/NNG 별/XSN 로/JKB 화분/NNG 대/XSN 계기/NNG 순서/NNG 가/JKS 먼저/MAG 확립/NNG 되/XSV 어야/EC 상대/NNG 편년/NNG 을/JKO 적용/NNG 하/XSV ㄹ/ETM 수/NNB 있/VA 음/EF ./SF
일주일 사용해봤는데... 더 쓰고 볼게요	일주일/NNG 사용/NNG 하/XSV 여/EC 보/VX 았/EP 는데/EF .../SF 더/MAG 쓰/VV 고/EC 보/VX ㄹ게요/EF
그럼 컴퓨터에게 좀더 편하고 우아하게 건물을 배치하고 유닛을 생산하도록 명령하는 방법은 없을까요?	그럼/MAJ 컴퓨터/NNG 에게/JKB 좀/MAG 더/MAG 편하/VA 고/EC 우아/XR 하/XSA 게/EC 건물/NNG 을/JKO 배치/NNG 하/XSV 고/EC 유닛/NNG 을/JKO 생산/NNG 하/XSV 도록/EC 명령/NNG 하/XSV 는/ETM 방법/NNG 은/JX 없/VA 을까요/EF ?/SF
아주좋아요 바지 정말 좋아서2개 더 구매했어요 이가격에 대박입니다. 바느질이 조금 엉성하긴 하지만 편하고 가성비 최고예요.	아주/MAG 좋/VA 아요/EF 바지/NNG 정말/MAG 좋/VA 아서/EC 2/SN 개/NNB 더/MAG 구매/NNG 하/XSV 였/EP 어요/EF 이/MM 가격/NNG 에/JKB 대박/NNG 이/VCP ㅂ니다/EF ./SF 바느질/NNG 이/JKS 조금/MAG 엉성/XR 하/XSA 기/ETN ㄴ/JX 하/VX 지만/EC 편하/VA 고/EC 가성비/NNG 최고/NNG 이/VCP 에요/EF ./SF
분유랑 같이 주문해서 받았어요. 깔끔하게 왔어요.	분유/NNG 랑/JKB 같이/MAG 주문/NNG 하/XSV 여서/EC 받/VV 았/EP 어요/EF ./SF 깔끔/XR 하/XSA 게/EC 오/VV 았/EP 어요/EF ./SF
좋습니다! 킨즈! 역시나 만족스러운 제품입니다.	좋/VA 습니다/EF !/SF 킨즈/NNP !/SF 역시/MAG 나/JX 만족/NNG 스럽/XSA ㄴ/ETM 제품/NNG 이/VCP ㅂ니다/EF ./SF
메모리를 많이 잡아먹고 큰 파일에서는 시간이 오래걸린다는 단점이 있지만, 그래도 꽤 쓸만한듯 하다. 나중에 별도로 이를 사용하여 midi to wave 프로그램을 만들어봐야겠다.	메모리/NNG 를/JKO 많이/MAG 잡아먹/VV 고/EC 크/VA ㄴ/ETM 파일/NNG 에서/JKB 는/JX 시간/NNG 이/JKS 오래/MAG 걸리/VV ㄴ다는/ETM 단점/NNG 이/JKS 있/VA 지만/EC ,/SP 그래도/MAJ 꽤/MAG 쓰/VV ㄹ/ETM 만/NNB 하/XSA ㄴ/ETM 듯/NNB 하/VV 다/EF ./SF 나중/NNG 에/JKB 별도/NNG 로/JKB 이/NP 를/JKO 사용/NNG 하/XSV 여/EC midi/SL to/SL wave/SL 프로그램/NNG 을/JKO 만들/VV 어/EC 보/VX 아야/EC 하/VX 겠/EP 다/EF ./SF
시원해서 잘쓸거같아요 여름에!	시원/XR 하/XSA 여서/EC 잘/MAG 쓰/VV ᆯ/ETM 거/NNB 같/VA 아요/EF 여름/NNG 에/JKB !/SF
아주 좋습니자	아주/MAG 좋/VA 습니자/EC
생각보다는 괜찮은거 같은데 약간 뻑뻑하네요	생각/NNG 보다/JKB 는/JX 괜찮/VA 은/ETM 것/NNB 같/VA 은데/EC 약간/MAG 뻑뻑/XR 하/XSA 네요/EF
배송 빠릅니다 지퍼 잘 잠깁니다 많이 파세요	배송/NNG 빠르/VA ㅂ니다/EF 지퍼/NNG 잘/MAG 잠기/VV ㅂ니다/EF 많이/MAG 팔/VV 세요/EF
왜 승무원 스프레이라고하는지 알겠네요 짱이에요. 흡수력 광택 @@	왜/MAG 승무원/NNG 스프레이/NNG 이/VCP 라고/EC 하/VV 는지/EC 알/VV 겠/EP 네요/EF 짱/NNG 이/VCP 에요/EF ./SF 흡수/NNG 력/XSN 광택/NNG @@/SW
수평이 잘 안맞긴하는데 예쁘긴합다!	수평/NNG 이/JKS 잘/MAG 안/MAG 맞/VV 기/ETN ᆫ/JX 하/VX 는데/EC 예쁘/VA 기/ETN ㄴ/JX 하/VX ㅂ다/EF !/SF
치약맛이 조금다르긴한데 상쾌하고 좋아요 재구매의사있어요	치약/NNG 맛/NNG 이/JKS 조금/NNG 다르/VA 기/ETN ᆫ/JX 하/VX ㄴ데/EC 상쾌/XR 하/XSA 고/EC 좋/VA 아요/EF 재/XPN 구매/NNG 의사/NNG 있/VX 어요/EF
하하, 이름대로 정말 단순히 배열을 담는 컨테이너입니다. vector와는 무엇이 다르냐? 하면 크기가 고정이 되어있다는 것이지요.	하하/IC ,/SP 이름/NNG 대로/JX 정말/MAG 단순히/MAG 배열/NNG 을/JKO 담/VV 는/ETM 컨테이너/NNG 이/VCP ㅂ니다/EF ./SF vector/SL 와/JKB 는/JX 무엇/NP 이/JKS 다르/VA 냐/EF ?/SF 하/VV 면/EC 크기/NNG 가/JKS 고정/NNG 이/JKC 되/VV 어/EC 있/VX 다는/ETM 것/NNB 이/VCP 지요/EF ./SF
데이터 개수는 긍정/부정을 5:5로 딱 맞추어서 모델이 긍/부정 편향 없이 학습을 진행하도록 하였고, 전체 데이터를 8:2로 나누어 8을 훈련 데이터, 2는 평가 데이터로 사용했습니다.	데이터/NNG 개수/NNG 는/JX 긍정/NNG //SP 부정/NNG 을/JKO 5:5/W_SERIAL 로/JKB 딱/MAG 맞추/VV 어서/EC 모델/NNG 이/JKS 긍/NNG //SP 부정/NNG 편향/NNG 없이/MAG 학습/NNG 을/JKO 진행/NNG 하/XSV 도록/EC 하/VX 였/EP 고/EC ,/SP 전체/NNG 데이터/NNG 를/JKO 8:2/W_SERIAL 로/JKB 나누/VV 어/EC 8/SN 을/JKO 훈련/NNG 데이터/NNG ,/SP 2/SN 는/JX 평가/NNG 데이터/NNG 로/JKB 사용/NNG 하/XSV 였/EP 습니다/EF ./SF
정성껏 키운 참외....는 아니고 그냥 먹고 텃밭예정지에 버렸는데 참외밭이 되버렸음.	정성껏/MAG 키우/VV ㄴ/ETM 참외/NNG ..../SF 는/JX 아니/VCN 고/EC 그냥/MAG 먹/VV 고/EC 텃밭/NNG 예정지/NNG 에/JKB 버리/VV 었/EP 는데/EC 참외/NNG 밭/NNG 이/JKC 되/VV 어/EC 버리/VX 었/EP 음/EF ./SF
안불렀어. 난 배 안 불렀어. 식섭아, 그럼 못 써. 아저씨도 실컷 달라 그래. 잊을 수 없는 개미와 배추만의 그 샌드위치	안/MAG 부르/VV 었/EP 어/EF ./SF 나/NP ㄴ/JX 배/NNG 안/MAG 부르/VV 었/EP 어/EF ./SF 식섭/NNP 아/JKV ,/SP 그럼/MAJ 못/MAG 쓰/VV 어/EF ./SF 아저씨/NNG 도/JX 실컷/MAG 달/VV 어/EC 그렇/VA 어/EF ./SF 잊/VV 을/ETM 수/NNB 없/VA 는/ETM 개미/NNG 와/JC 배추/NNG 만/JX 의/JKG 그/MM 샌드위치/NNG
오늘 저녁에 먹었던 김밥이에요 지에스 편의점 갔다가 사먹었는데 삼각김밥류만 먹다가 이런류는 처음먹어보는데 맛은 나쁘지 않았어요.	오늘/NNG 저녁/NNG 에/JKB 먹/VV 었/EP 던/ETM 김밥/NNG 이/VCP 에요/EF 지에스/NNP 편의점/NNG 가/VV 었/EP 다가/EC 사/VV 어/EC 먹/VV 었/EP 는데/EC 삼각/NNG 김밥/NNG 류/XSN 만/JX 먹/VV 다가/EC 이런/MM 류/XSN 는/JX 처음/NNG 먹/VV 어/EC 보/VX 는데/EC 맛/NNG 은/JX 나쁘/VA 지/EC 않/VX 었/EP 어요/EF ./SF
양이 살짝 적은 느낌이었는데 가격이나 이런것을 생각헀을땐 나쁘지 않았던 느낌. 맛있게 먹었습니다. 점수는 80점입니다.	양/NNG 이/JKS 살짝/MAG 적/VA 은/ETM 느낌/NNG 이/VCP 었/EP 는데/EC 가격/NNG 이나/JC 이런/MM 것/NNB 을/JKO 생각/NNG 하/XSV 었/EP 을/ETM 때/NNG ㄴ/JX 나쁘/VA 지/EC 않/VX 었/EP 던/ETM 느낌/NNG ./SF 맛있/VA 게/EC 먹/VV 었/EP 습니다/EF ./SF 점수/NNG 는/JX 80/SN 점/NNB 이/VCP ㅂ니다/EF ./SF
손에 들린 김밥은 꽤 커 보이는데 양이 약간 적다고 하신 걸 봐서는, 뚠뚠하고 짧은 김밥 같습니다. ㅎㅎ	손/NNG 에/JKB 들리/VV ㄴ/ETM 김밥/NNG 은/JX 꽤/MAG 크/VA 어/EC 보이/VV 는데/EC 양/NNG 이/JKS 약간/MAG 적/VA 다고/EC 하/VV 시/EP ㄴ/ETM 것/NNB ㄹ/JKO 보/VV 어서/EC 는/JX ,/SP 뚠뚠/XR 하/XSA 고/EC 짧/VA 은/ETM 김밥/NNG 같/VA 습니다/EF ./SF ㅎㅎ/SW
그럼 그냥 설명하고 내려오라고 말로 하면 되지 일단 끌어내고 보는게 정상은 아님	그럼/MAJ 그냥/MAG 설명/NNG 하/XSV 고/EC 내려오/VV 라고/EC 말/NNG 로/JKB 하/VV 면/EC 되/VV 지/EC 일단/MAG 끌어내/VV 고/EC 보/VX 는/ETM 것/NNB 이/JKS 정상/NNG 은/JX 아니/VCN ㅁ/EF
본문에는 '보도를 막은 이유는 확인 안 됐다.'고 나옴. 어쩌면 화단 위라서 쫓아냈다는 게 선동이었을 수도 있겠네	본문/NNG 에/JKB 는/JX '/SSO 보도/NNG 를/JKO 막/VV 은/ETM 이유/NNG 는/JX 확인/NNG 안/MAG 되/VV 었/EP 다/EF ./SF '/SSC 고/JKQ 나오/VV ㅁ/EF ./SF 어쩌면/MAG 화단/NNG 위/NNG 이/VCP 라서/EC 쫓아내/VV 었/EP 다는/ETM 것/NNB 이/JKS 선동/NNG 이/VCP 었/EP 을/ETM 수/NNB 도/JX 있/VA 겠/EP 네/EF
니들은 그걸 '근대화' 라고 주장했잖아. 근대화 해준다는데 왜 울어? ㅋㅋㅋㅋㅋ	니/NP 들/XSN 은/JX 그것/NP ㄹ/JKO '/SSO 근대/NNG 화/XSN '/SSC 라고/JKQ 주장/NNG 하/XSV 었/EP 잖아/EF ./SF 근대/NNG 화/XSN 하/VV 어/EC 주/VX ㄴ다는데/EC 왜/MAG 울/VV 어/EF ?/SF ㅋㅋㅋㅋㅋ/SW
일제시대 때 조선인들에게 했던 건데 왜 주어가 달라지자 패악질하는 것인양 묘사하지	일제/NNG 시대/NNG 때/NNG 조선인/NNP 들/XSN 에게/JKB 하/VV 었/EP 던/ETM 것/NNB 이/VCP ㄴ데/EC 왜/MAG 주어/NNG 가/JKS 달라지/VV 자/EC 패악/NNG 질/XSN 하/XSV 는/ETM 것/NNB 이/VCP ㄴ/ETM 양/NNB 묘사/NNG 하/XSV 지/EF
이거 뭔만화임? 작가가 뭔갈 알고있긴하네 ㅋㅋ 써먹는걸보니..	이거/NP 뭐/NP ㄴ/JX 만화/NNG 이/VCP ㅁ/EF ?/SF 작가/NNG 가/JKS 뭐/NP 이/VCP ㄴ가/EC ㄹ/JKO 알/VV 고/EC 있/VX 기/ETN ㄴ/JX 하/VX 네/EF ㅋㅋ/SW 써먹/VV 는/ETM 것/NNB ㄹ/JKO 보/VV 니/EF ../SF
조명교체 혼자하느라 힘들었지만(더군다나 한땀한땀 자개 단다고 일어섰다 앉았다;;;) 	조명/NNG 교체/NNG 혼자/NNG 하/XSV 느라/EC 힘들/VA 었/EP 지만/EC (/SSO 더군다나/MAG 한땀한땀/MAG 자개/NNG 달/VV ㄴ다고/EC 일어서/VV 었/EP 다/EC 앉/VV 었/EP 다/EF ;;;/SP )/SSC
역시 안다르! 보온성도 좋고 촉감도 너무 좋아요 핏도 이뻐서 어떤 상의도 소화할수 있어요 겨울부터 봄까지 정말즐겨입게되는 치마! 사길 정말 잘했어요!	역시/MAG 안다르/NNP !/SF 보온/NNG 성/XSN 도/JX 좋/VA 고/EC 촉감/NNG 도/JX 너무/MAG 좋/VA 어요/EC 핏/NNG 도/JX 이쁘/VA 어서/EC 어떤/MM 상의/NNG 도/JX 소화/NNG 하/XSV ㄹ/ETM 수/NNB 있/VA 어요/EF 겨울/NNG 부터/JX 봄/NNG 까지/JX 정말/MAG 즐겨/VV 입/VV 게/EC 되/VV 는/ETM 치마/NNG !/SF 사/VV 기/ETN ㄹ/JKO 정말/MAG 잘/MAG 하/XSV 었/EP 어요/EF !/SF
어서오세요 / 안녕하 가세요 아 시끄럽다. 인사 하는건 좋은데... 맡은 테이블에 좀 더 집중 했으면 한다.	어서/MAG 오/VV 세요/EC //SP 안녕/NNG 하/XSA 가/VV 세요/EC 아/IC 시끄럽/VA 다/EF ./SF 인사/NNG 하/VV 는/ETM 것/NNB ㄴ/JX 좋/VA 은데/EC .../SF 맡/VV 은/ETM 테이블/NNG 에/JKB 좀/MAG 더/MAG 집중/NNG 하/XSV 었/EP 으면/EC 하/VX ㄴ다/EF ./SF
_ 세 번째 에피소드는 결혼사기를 위해 만난 두 여자다. 하지만 둘은 대화를 통해 묘한 교감을 형성한다. 잠시 동안이지만, 서로를 딸, 엄마처럼 여기는 두 사람의 에피소드는 남녀 간의 이야기가 아니라 더 특별하게 다가온다. _	_/SW 세/MM 번/NNB 째/XSN 에피소드/NNG 는/JX 결혼/NNG 사기/NNG 를/JKO 위하/VV 어/EC 만나/VV ㄴ/ETM 두/MM 여자/NNG 이/VCP 다/EF ./SF 하지만/MAJ 둘/NR 은/JX 대화/NNG 를/JKO 통하/VV 어/EC 묘하/VA ㄴ/ETM 교감/NNG 을/JKO 형성/NNG 하/XSV ㄴ다/EF ./SF 잠시/MAG 동안/NNG 이/VCP 지만/EC ,/SP 서로/NNG 를/JKO 딸/NNG ,/SP 엄마/NNG 처럼/JKB 여기/VV 는/ETM 두/MM 사람/NNG 의/JKG 에피소드/NNG 는/JX 남녀/NNG 간/NNB 의/JKG 이야기/NNG 가/JKC 아니/VCN 라/EC 더/MAG 특별/NNG 하/XSA 게/EC 다가오/VV ㄴ다/EF ./SF _/SW
앙뇽하세용! 요새 계속 먹고 또 먹는 기념으로 쓰는 포스팅! 요새 진짜 계속 고기가 땡겨요ㅠㅠ 고기는 정말 먹고 또 먹어도 안질리는 듯해요..	앙뇽하세용/IC !/SF 요새/MAG 계속/MAG 먹/VV 고/EC 또/MAJ 먹/VV 는/ETM 기념/NNG 으로/JKB 쓰/VV 는/ETM 포스팅/NNG !/SF 요새/MAG 진짜/MAG 계속/MAG 고기/NNG 가/JKS 땡기/VV 어요/EF ㅠㅠ/SW 고기/NNG 는/JX 정말/MAG 먹/VV 고/EC 또/MAG 먹/VV 어도/EC 안/MAG 질리/VV 는/ETM 듯/NNB 하/XSA 어요/EF ../SF
이런 단점들에도 불구하고 영화는 뒤로갈수록 나름의 매력을 과시한다. 막강 조연들과 까메오들의 뒷받침도 그렇고 한효주를 중심으로 벌어지는 대화나 상황이 재밌다.	이런/MM 단점/NNG 들/XSN 에/JKB 도/JX 불구/XR 하/XSV 고/EC 영화/NNG 는/JX 뒤/NNG 로/JKB 가/VV ㄹ수록/EC 나름/NNB 의/JKG 매력/NNG 을/JKO 과시/NNG 하/XSV ㄴ다/EF ./SF 막강/NNG 조연/NNG 들/XSN 과/JC 까메오/NNG 들/XSN 의/JKG 뒷받침/NNG 도/JX 그렇/VA 고/EC 한효주/NNP 를/JKO 중심/NNG 으로/JKB 벌어지/VV 는/ETM 대화/NNG 나/JC 상황/NNG 이/JKS 재밌/VA 다/EF ./SF
다시한번 강조하지만 경매에서 경쟁을 피할 수 있는 방법은 실로 다양하며 수익을 낼수 있는 틈새도 적지 않다. 그럼에도 자신의 한계를, 자신의 선입견을 벗어나지 못해 쉽고 편한 물건에만 관심을 두고 경쟁이 너무 치열하다며 한 숨만 쉬고 있으니 참으로 안타깝다.	다시/MAG 한/MM 번/NNB 강조/NNG 하/XSV 지만/EC 경매/NNG 에서/JKB 경쟁/NNG 을/JKO 피하/VV ㄹ/ETM 수/NNB 있/VA 는/ETM 방법/NNG 은/JX 실로/MAG 다양/NNG 하/XSA 며/EC 수익/NNG 을/JKO 내/VV ㄹ/ETM 수/NNB 있/VA 는/ETM 틈새/NNG 도/JX 적/VA 지/EC 않/VX 다/EF ./SF 그렇/VA ㅁ/ETN 에/JKB 도/JX 자신/NNG 의/JKG 한계/NNG 를/JKO ,/SP 자신/NNG 의/JKG 선입견/NNG 을/JKO 벗어나/VV 지/EC 못/MAG 하/VV 어/EC 쉽/VA 고/EC 편하/VA ㄴ/ETM 물건/NNG 에/JKB 만/JX 관심/NNG 을/JKO 두/VV 고/EC 경쟁/NNG 이/JKS 너무/MAG 치열/NNG 하/XSA 다며/EC 한숨/NNG 만/JX 쉬/VV 고/EC 있/VX 으니/EC 참으로/MAG 안타깝/VA 다/EF ./SF
5윌이 본격적으로 시작되고.. 벌써 7일이나 지났네요~ 앞으로 점점 더워질 일만 남았어요~ 그래서 오늘은 예전에 파파님과 후식으로 먹고 왔던 전주맛집 면빙수 소개해드리려고요~	5/SN 월/NNB 이/JKS 본격/NNG 적/XSN 으로/JKB 시작/NNG 되/XSV 고/EF ../SF 벌써/MAG 7/SN 일/NNB 이나/JX 지나/VV 었/EP 네요/EF ~/SO 앞/NNG 으로/JKB 점점/MAG 덥/VA 어/EC 지/VX ㄹ/ETM 일/NNG 만/JX 남/VV 었/EP 어요/EF ~/SO 그래서/MAJ 오늘/NNG 은/JX 예전/NNG 에/JKB 파파/NNP 님/XSN 과/JC 후식/NNG 으로/JKB 먹/VV 고/EC 오/VX 었/EP 던/ETM 전주/NNP 맛집/NNG 면빙수/NNP 소개/NNG 하/XSV 어/EC 드리/VX 려고/EF 요/JX ~/SO
탄탄하고 탱글탱글한 피부는 얼굴 생김새와 무관하게 모든 사람을 젊어보이게 만들어주죠. 피부에 주름이 몇개나 있냐에 따라 나이가 확 젊어보이기도 하고 확 들어보이기도 하니까 주름개선화장품으로 더 열심히 관리해줘야 해요!	탄탄/XR 하/XSA 고/EC 탱글탱글/MAG 하/XSA ㄴ/ETM 피부/NNG 는/JX 얼굴/NNG 생김새/NNG 와/JKB 무관하/VA 게/EC 모든/MM 사람/NNG 을/JKO 젊/VA 어/EC 보이/VV 게/EC 만들/VV 어/EC 주/VX 죠/EF ./SF 피부/NNG 에/JKB 주름/NNG 이/JKS 몇/MM 개/NNB 나/JX 있/VA 냐/EF 에/JKB 따르/VV 어/EC 나이/NNG 가/JKS 확/MAG 젊/VA 어/EC 보이/VV 기/ETN 도/JX 하/VX 고/EC 확/MAG 들/VV 어/EC 보이/VV 기/ETN 도/JX 하/VX 니까/EC 주름/NNG 개선/NNG 화장품/NNG 으로/JKB 더/MAG 열심히/MAG 관리/NNG 하/XSV 어/EC 주/VX 어야/EC 하/VX 어요/EF !/SF
#뷰티크리에이터 #springwakeup . . . 인스타 통해 알게된 예쁜 우정이랑 ♥  함께라서 행복한   . . 놀면서 돈벌기   #뷰티프리랜서	#뷰티크리에이터/W_HASHTAG #springwakeup/W_HASHTAG ./SF ./SF ./SF 인스타/NNP 통하/VV 어/EC 알/VV 게/EC 되/VV ㄴ/ETM 예쁘/VA ㄴ/ETM 우정/NNG 이랑/JC ♥/SW 함께/MAG 이/VCP 라서/EC 행복/NNG 하/XSA ㄴ/ETM ./SF ./SF 놀/VV 면서/EC 돈/NNG 벌/VV 기/ETN #뷰티프리랜서/W_HASHTAG
저는 5성 장수로 지옥까지 갔습니다 4성 아이템만 잘 주워서 12까지 강화하면 할만해요 아이템은 어려움에서 얻어야 3~4성짜리를 먹을 수 있고, 각 아이템 정보를 눌러서 어디서 떨어지는 파악하고 가서 먹으면 됩니다 생각보다 안나올 수 도 있는데	저/NP 는/JX 5/SN 성/NNB 장수/NNG 로/JKB 지옥/NNG 까지/JX 가/VV 었/EP 습니다/EF 4/SN 성/NNB 아이템/NNG 만/JX 잘/MAG 줍/VV 어서/EC 12/SN 까지/JX 강화/NNG 하/XSV 면/EC 하/VV ㄹ/ETM 만/NNB 하/XSA 어요/EF 아이템/NNG 은/JX 어려움/NNG 에서/JKB 얻/VV 어야/EC 3/SN ~/SO 4/SN 성/NNB 짜리/XSN 를/JKO 먹/VV 을/ETM 수/NNB 있/VA 고/EC ,/SP 각/MM 아이템/NNG 정보/NNG 를/JKO 누르/VV 어서/EC 어디/NP 서/JKB 떨어지/VV 는/ETM 파악/NNG 하/XSV 고/EC 가/VV 어서/EC 먹/VV 으면/EC 되/VV ㅂ니다/EF 생각/NNG 보다/JKB 안/MAG 나오/VV ㄹ/ETM 수/NNB 도/JX 있/VA 는데/EC
첫입은 양파절임과 함께 ♥ 두번째는 상추, 깻잎과 쌈 싸서 함께 ♥ 세번째는 콩나물파무침과 함께 ♥ 네번째는 쌈무와 함께 ♥ 다섯 번째는 쌀밥과 함께 ♥ 먹으니 고기 순삭 ㅋㅋㅋㅋㅋㅋㅋㅋㅋ ㅠㅠㅠㅠㅠ	첫/MM 입/NNG 은/JX 양파/NNG 절임/NNG 과/JKB 함께/MAG ♥/SW 두/MM 번/NNB 째/XSN 는/JX 상추/NNG ,/SP 깻잎/NNG 과/JKB 쌈/NNG 싸/VV 어서/EC 함께/MAG ♥/SW 세/MM 번/NNB 째/XSN 는/JX 콩나물/NNG 파/NNG 무침/NNG 과/JKB 함께/MAG ♥/SW 네/MM 번/NNB 째/XSN 는/JX 쌈무/NNG 와/JKB 함께/MAG ♥/SW 다섯/NR 번/NNB 째/XSN 는/JX 쌀밥/NNG 과/JKB 함께/MAG ♥/SW 먹/VV 으니/EC 고기/NNG 순삭/NNG ㅋㅋㅋㅋㅋㅋㅋㅋㅋ/SW ㅠㅠㅠㅠㅠ/SW
일본 오키나와 여행 #4 호텔 유가후 인 비세 후기 이번 4박 5일 오키나와 여행에서 오키나와 북부에서 3박, 나하에서 1박 이렇게 2곳의 호텔에서 숙박을 했는데, 첫번째 호텔은 오키나와 북부에 위치한 `호텔 유가후 인 비세(Hotel Yugaf Inn Bise, 호텔 유가프 인 비세)` 에서 3박을 했다.	일본/NNP 오키나와/NNP 여행/NNG #/SW 4/SN 호텔/NNG 유가후/NNP 인/NNP 비세/NNP 후기/NNG 이번/NNG 4/SN 박/NNB 5/SN 일/NNB 오키나와/NNP 여행/NNG 에서/JKB 오키나와/NNP 북부/NNG 에서/JKB 3/SN 박/NNB ,/SP 나하/NNP 에서/JKB 1/SN 박/NNB 이렇게/MAG 2/SN 곳/NNG 의/JKG 호텔/NNG 에서/JKB 숙박/NNG 을/JKO 하/VV 었/EP 는데/EC ,/SP 첫/MM 번/NNB 째/XSN 호텔/NNG 은/JX 오키나와/NNP 북부/NNG 에/JKB 위치/NNG 하/XSV ㄴ/ETM `/SW 호텔/NNG 유가후/NNP 인/NNP 비세/NNP (/SSO Hotel/SL Yugaf/SL Inn/SL Bise/SL ,/SP 호텔/NNG 유가프/NNP 인/NNP 비세/NNP )/SSC `/SW 에서/JKB 3/SN 박/NNB 을/JKO 하/VV 었/EP 다/EF ./SF
그러나 관객이 마치 독립군의 일원이 되어 임무를 수행하는 것 같은 착각을 불러일으키며, 독립군으로 살아간다는게 얼마나 살얼음 위를 걷는, 힘든 일이었는지를 실감케 한다. 아마도 그것이 이 영화의, 김지운 감독의 목적이었을 것이다.	그러나/MAJ 관객/NNG 이/JKS 마치/MAG 독립/NNG 군/NNG 의/JKG 일원/NNG 이/JKC 되/VV 어/EC 임무/NNG 를/JKO 수행/NNG 하/XSV 는/ETM 것/NNB 같/VA 은/ETM 착각/NNG 을/JKO 불러일으키/VV 며/EC ,/SP 독립군/NNG 으로/JKB 살아가/VV ㄴ다는/ETM 것/NNB 이/JKS 얼마나/MAG 살얼음/NNG 위/NNG 를/JKO 걷/VV 는/ETM ,/SP 힘들/VA ㄴ/ETM 일/NNG 이/VCP 었/EP 는지/EC 를/JKO 실감/NNG 하/XSV 게/EC 하/VX ㄴ다/EF ./SF 아마도/MAG 그것/NP 이/JKS 이/MM 영화/NNG 의/JKG ,/SP 김지운/NNP 감독/NNG 의/JKG 목적/NNG 이/VCP 었/EP 을/ETM 것/NNB 이/VCP 다/EF ./SF
저희 자리에서 창문 밖을 보면 토리고야가 바로 보여요~ 합정에서 많이 본 인테리어의 가게 더라구요~ 자리에 앉으면 피지 라는 물을 준답니다~	저희/NP 자리/NNG 에서/JKB 창문/NNG 밖/NNG 을/JKO 보/VV 면/EC 토리고야/NNP 가/JKS 바로/MAG 보이/VV 어요/EF ~/SO 합정/NNP 에서/JKB 많이/MAG 보/VV ㄴ/ETM 인테리어/NNG 의/JKG 가게/NNG 이/VCP 더라구요/EF ~/SO 자리/NNG 에/JKB 앉/VV 으면/EC 피지/NNP 이/VCP 라는/ETM 물/NNG 을/JKO 주/VV ㄴ답니다/EF ~/SO
그리고 무엇보다 좋았떤 해물 샤브샤브 코너. 고기추가할 필요없이 해산물 좋아하시면 하나 더 겟하는 기분이 들어요. 싱싱한 샤브샤브용 해물들을 마음껏 갖다 먹을 수 있네요.	그리고/MAJ 무엇/NP 보다/JKB 좋/VA 았/EP 던/ETM 해물/NNG 샤브샤브/NNG 코너/NNG ./SF 고기/NNG 추가/NNG 하/XSV ㄹ/ETM 필요/NNG 없이/MAG 해산/NNG 물/XSN 좋아하/VV 시/EP 면/EC 하나/NR 더/MAG 겟/NNG 하/XSV 는/ETM 기분/NNG 이/JKS 들/VV 어요/EF ./SF 싱싱/XR 하/XSA ㄴ/ETM 샤브샤브/NNG 용/XSN 해물/NNG 들/XSN 을/JKO 마음껏/MAG 갖/VV 다/EC 먹/VV 을/ETM 수/NNB 있/VA 네/EF 요/JX ./SF
그리고 엔딩곡이 나오는데.. 이 엔딩곡의 가사가 참.. 과군왕의 어머니 서태비가 살던 곳 동화대. 이때의 `동`자가 오동나무할때의 동을 말한다 가사의 마지막에도 오동나무가 나오는데..	그리고/MAJ 엔딩곡/NNG 이/JKS 나오/VV 는데/EC ../SF 이/MM 엔딩곡/NNG 의/JKG 가사/NNG 가/JKS 참/IC ../SF 과군왕/NNP 의/JKG 어머니/NNG 서태비/NNP 가/JKS 살/VV 던/ETM 곳/NNG 동화대/NNP ./SF 이때/NNG 의/JKG `/SW 동/NNG `/SW 자/NNG 가/JKS 오동나무/NNG 하/XSV ㄹ/ETM 때/NNG 의/JKG 동/NNG 을/JKO 말/NNG 하/XSV ㄴ다/EF 가사/NNG 의/JKG 마지막/NNG 에/JKB 도/JX 오동나무/NNG 가/JKS 나오/VV 는데/EC ../SF
경기도 어린이박물관 사람없는 날 다녀왔던 경기도 어린이 박물관. 예전부터 한번 가리라 마음먹었었는데... 이제서야 방문하게 됐다는.. 미리 예약하고 시간대 맞춰서 갔는데 정말 하루 종일 놀다 온것 같다.	경기도/NNP 어린이/NNG 박물관/NNG 사람/NNG 없/VA 는/ETM 날/NNG 다녀오/VV 었/EP 던/ETM 경기도/NNP 어린이/NNG 박물관/NNG ./SF 예전/NNG 부터/JX 한번/MAG 가/VV 리라/EC 마음먹/VV 었었/EP 는데/EF .../SF 이제/NNG 서/JKB 야/JX 방문/NNG 하/XSV 게/EC 되/VV 었/EP 다는/ETM ../SF 미리/MAG 예약/NNG 하/XSV 고/EC 시간대/NNG 맞추/VV 어서/EC 가/VV 었/EP 는데/EC 정말/MAG 하루/NNG 종일/NNG 놀/VV 다/EC 오/VV ㄴ/ETM 것/NNB 같/VA 다/EF ./SF
안녕하세요~ 루이스입니다! 오늘 제가 포스팅할 제품은 연예인향수로 유명한 레피소드 드레스퍼퓸입니다! 박스 포장이 정말 깔끔하게 잘되어서 배송되었더라구요~ 벌써부터 마음에 드네요^^	안녕/NNG 하/XSA 세요/EF ~/SO 루이스/NNP 이/VCP ㅂ니다/EF !/SF 오늘/MAG 저/NP 가/JKS 포스팅/NNG 하/XSV ㄹ/ETM 제품/NNG 은/JX 연예인/NNG 향수/NNG 로/JKB 유명/NNG 하/XSA ㄴ/ETM 레피소드/NNP 드레스퍼퓸/NNP 이/VCP ㅂ니다/EF !/SF 박스/NNG 포장/NNG 이/JKS 정말/MAG 깔끔/NNG 하/XSA 게/EC 잘/MAG 되/XSV 어서/EC 배송/NNG 되/XSV 었/EP 더라구요/EF ~/SO 벌써/MAG 부터/JX 마음/NNG 에/JKB 들/VV 네요/EF ^^/SW
2) 월드 2-2에서 코인 31개 중 30개 입수, 아이템은 `닻` 3) 월드 3-8에서 코인 47개 중 44개 입수, 아이템은 `파닥파닥 날개` 4) 월드 4-2에서 코인 24개 중 24개 입수, 아이템은 `닻`	2)/SB 월드/NNG 2-2/W_SERIAL 에서/JKB 코인/NNG 31/SN 개/NNB 중/NNB 30/SN 개/NNB 입수/NNG ,/SP 아이템/NNG 은/JX `/SW 닻/NNG `/SW 3)/SB 월드/NNG 3-8/W_SERIAL 에서/JKB 코인/NNG 47/SN 개/NNB 중/NNB 44/SN 개/NNB 입수/NNG ,/SP 아이템/NNG 은/JX `/SW 파닥파닥/NNG 날개/NNG `/SW 4)/SB 월드/NNG 4-2/W_SERIAL 에서/JKB 코인/NNG 24/SN 개/NNB 중/NNB 24/SN 개/NNB 입수/NNG ,/SP 아이템/NNG 은/JX `/SW 닻/NNG `/SW
4연패 대 3연패의 만남. 각각 NC와 롯데에 싹쓸이 패를 당한 SK와 기아의 광주 경기는 9회 말 2 사 1루에서 터진 김선빈의 극적인 동점 홈런으로 승부를 연장으로 몰고간 뒤 버나디나의 기습번트가 끝내기 실책으로 김주찬이 결승 득점을 올려 절망적이었던 기아 팬들을 열광케 했다.	4/SN 연패/NNG 대/NNB 3/SN 연패/NNG 의/JKG 만남/NNG ./SF 각각/MAG NC/SL 와/JC 롯데/NNP 에/JKB 싹쓸이/NNG 패/NNG 를/JKO 당하/VV ㄴ/ETM SK/SL 와/JC 기아/NNP 의/JKG 광주/NNP 경기/NNG 는/JX 9/SN 회/NNB 말/NNB 2/SN 사/NNG 1/SN 루/NNG 에서/JKB 터지/VV ㄴ/ETM 김선빈/NNP 의/JKG 극/NNG 적/XSN 이/VCP ㄴ/ETM 동점/NNG 홈런/NNG 으로/JKB 승부/NNG 를/JKO 연장/NNG 으로/JKB 몰/VV 고/EC 가/VV ㄴ/ETM 뒤/NNG 버나디나/NNP 의/JKG 기습/NNG 번트/NNG 가/JKS 끝내기/NNG 실책/NNG 으로/JKB 김주찬/NNP 이/JKS 결승/NNG 득점/NNG 을/JKO 올리/VV 어/EC 절망/NNG 적/XSN 이/VCP 었/EP 던/ETM 기아/NNP 팬/NNG 들/XSN 을/JKO 열광/NNG 하/XSV 게/EC 하/VX 었/EP 다/EF ./SF
요괴 사토리에 대한 대응은 `아무것도 생각하지 않는 것`이라고 한다. 토로스테 요괴에마키 5번째 사토리.다음 요괴는 불을 피우면 사람 얼굴 모양의 연기가 나는 요괴 엔엔라.	요괴/NNG 사토리/NNP 에/JKB 대하/VV ㄴ/ETM 대응/NNG 은/JX `/SW 아무/MM 것/NNG 도/JX 생각/NNG 하/XSV 지/EC 않/VX 는/ETM 것/NNB `/SW 이/VCP 라고/EC 하/VV ㄴ다/EF ./SF 토로스테/NNP 요괴에마키/NNP 5/SN 번/NNB 째/XSN 사토리/NNP ./SF 다음/NNG 요괴/NNG 는/JX 불/NNG 을/JKO 피우/VV 면/EC 사람/NNG 얼굴/NNG 모양/NNG 의/JKG 연기/NNG 가/JKS 나/VV 는/ETM 요괴/NNG 엔엔라/NNP ./SF
오늘은 스포츠용 블루투스 이어폰인 루닉스 라인의 리뷰를 남겨볼까합니다. 루닉스 라인 리뷰 #1 개봉기, 디자인 살펴보기 ▷ `스마트한 세상! 더욱 스마트하게!`라는 로고가 새겨진 종이+ 플라스틱 재질의 상자 루닉스는 블루투스 이어폰/ 헤드셋 브랜드로 리드/원/프리/큐브등 중저가형 위주로 다양한 제품이 출시되고있습니다.	오늘/NNG 은/JX 스포츠/NNG 용/XSN 블루투스/NNG 이어폰/NNG 이/VCP ㄴ/ETM 루닉스/NNP 라인/NNG 의/JKG 리뷰/NNG 를/JKO 남기/VV 어/EC 보/VX ㄹ까/EF 하/VX ㅂ니다/EF ./SF 루닉스/NNP 라인/NNG 리뷰/NNG #/SW 1/SN 개봉기/NNG ,/SP 디자인/NNG 살펴보/VV 기/ETN ▷/SW `/SW 스마트/NNG 하/XSA ㄴ/ETM 세상/NNG !/SF 더욱/MAG 스마트/NNG 하/XSV 게/EC !/SF `/SW 이/VCP 라는/ETM 로고/NNG 가/JKS 새기/VV 어/EC 지/VX ㄴ/ETM 종이/NNG +/SW 플라스틱/NNG 재질/NNG 의/JKG 상자/NNG 루닉스/NNP 는/JX 블루투스/NNG 이어폰/NNG //SP 헤드셋/NNG 브랜드/NNG 로/JKB 리드/NNP //SP 원/NNP //SP 프리/NNP //SP 큐브/NNP 등/NNB 중저가/NNG 형/XSN 위주/NNG 로/JKB 다양/NNG 하/XSA ㄴ/ETM 제품/NNG 이/JKS 출시/NNG 되/XSV 고/EC 있/VX 습니다/EF ./SF
보만 침구 청소기는 침구속 습기제거도 되기 때문에 집먼지 진드기들이 좋아하는 습한곳과 사람의 땀을 나름 제거해 주고 있어요 침구 청소기를 바닥에 두고 전원을 키면 이렇게 UV살균 기능 작동됩니다 마치 자동차 헤드라이트처럼 밝은 불이 들어오죵 이불과 배게가 있는 곳이라 머리카락 많이 떨어지는데 청소기라 머리카락을 싹 먹어주더라구요	보만/NNP 침구/NNG 청소기/NNG 는/JX 침구/NNG 속/NNG 습기/NNG 제거/NNG 도/JX 되/VV 기/ETN 때문/NNB 에/JKB 집/NNG 먼지/NNG 진드기/NNG 들/XSN 이/JKS 좋아하/VV 는/ETM 습하/VA ᆫ/ETM 곳/NNG 과/JC 사람/NNG 의/JKG 땀/NNG 을/JKO 나름/NNB 제거/NNG 하/XSV 어/EC 주/VX 고/EC 있/VX 어요/EF 침구/NNG 청소기/NNG 를/JKO 바닥/NNG 에/JKB 두/VV 고/EC 전원/NNG 을/JKO 키/VV 면/EC 이렇/VA 게/EC UV/SL 살균/NNG 기능/NNG 작동/NNG 되/XSV ㅂ니다/EF 마치/MAG 자동차/NNG 헤드라이트/NNG 처럼/JKB 밝/VA 은/ETM 불/NNG 이/JKS 들어오/VV 죵/EF 이불/NNG 과/JC 배게/NNG 가/JKS 있/VA 는/ETM 곳/NNG 이/VCP 라/EC 머리카락/NNG 많이/MAG 떨어지/VV 는데/EC 청소기/NNG 이/VCP 라/EC 머리카락/NNG 을/JKO 싹/MAG 먹/VV 어/EC 주/VX 더라구요/EF
짱걸이예요 요즘은 고기도 유행시대~~ 목살은 목살인데 꼬들목살이 또 대세더라구요 울산 명촌 맛집 미소담은갈비집에 다녀왔답니다 안쪽 넓은 룸도 있어서 회식장소로도 좋은 식당 밖에는 테이블로 되어있ㄱ요	짱걸/NNP 이/VCP 에요/EC 요즘/NNG 은/JX 고기/NNG 도/JX 유행/NNG 시대/NNG ~/SO ~/SO 목살/NNG 은/JX 목살/NNG 이/VCP ㄴ데/EC 꼬들/NNG 목살/NNG 이/JKS 또/MAG 대세/NNG 이/VCP 더라구요/EF 울산/NNP 명촌/NNP 맛집/NNG 미소/NNG 담/VV 은/ETM 갈비/NNG 집/NNG 에/JKB 다녀오/VV 었/EP 답니다/EF 안/NNG 쪽/NNB 넓/VA 은/ETM 룸/NNG 도/JX 있/VA 어서/EC 회식/NNG 장소/NNG 로/JKB 도/JX 좋/VA 은/ETM 식당/NNG 밖/NNG 에/JKB 는/JX 테이블/NNG 로/JKB 되/VV 어/EC 있/VX ㄱ요/EF
거기서 너무 피곤해서 <위플래쉬>를 보기전 한시간정도 엎드려잤는데, 몸이 정말 피곤하면 주위가 시장바닥 못지않게 시끄러워도 꿀잠을 잘 수 있다는것을 알았다. 전단지와 포스터들이 한데 모여있으니 영화제에 참석하는 사람들은 필히 한번은 와야할 곳이었다.	거기/NP 서/JKB 너무/MAG 피곤/NNG 하/XSA 어서/EC </SSO 위플래쉬/NNP >/SSC 를/JKO 보/VV 기/ETN 전/NNG 한/MM 시간/NNG 정도/NNG 엎드리/VV 어/EC 자/VV 었/EP 는데/EC ,/SP 몸/NNG 이/JKS 정말/MAG 피곤/NNG 하/XSA 면/EC 주위/NNG 가/JKS 시장/NNG 바닥/NNG 못지않/VA 게/EC 시끄럽/VA 어도/EC 꿀/NNG 잠/NNG 을/JKO 자/VV ㄹ/ETM 수/NNB 있/VA 다는/ETM 것/NNB 을/JKO 알/VV 었/EP 다/EF ./SF 전단지/NNG 와/JC 포스터/NNG 들/XSN 이/JKS 한데/NNG 모이/VV 어/EC 있/VX 으니/EC 영화제/NNG 에/JKB 참석/NNG 하/XSV 는/ETM 사람/NNG 들/XSN 은/JX 필히/MAG 한/MM 번/NNB 은/JX 오/VV 어야/EC 하/VX ㄹ/ETM 곳/NNG 이/VCP 었/EP 다/EF ./SF
애정이웃 쫑알 누나가 신청해주신 통기타 곡 변진섭 의 우리의사랑이 필요한거죠 를 연습해봤습니다. 아주 어려운곡이 아니라면 연주해달라고 요청해주시면, 어느정도 연주해드린답니다	애정/NNG 이웃/NNG 쫑알/NNP 누나/NNG 가/JKS 신청/NNG 하/XSV 어/EC 주/VX 시/EP ㄴ/ETM 통기타/NNG 곡/NNG 변진섭/NNP 의/JKG 우리/NP 의/JKG 사랑/NNG 이/JKS 필요/NNG 하/XSA ᆫ/ETM 거/NNB 이/VCP 죠/EF 를/JKO 연습/NNG 하/XSV 어/EC 보/VX 었/EP 습니다/EF ./SF 아주/MAG 어렵/VA 은/ETM 곡/NNG 이/JKC 아니/VCN 라면/EC 연주/NNG 하/XSV 어/EC 달/VX 라고/EC 요청/NNG 하/XSV 어/EC 주/VX 시/EP 면/EC ,/SP 어느/MM 정도/NNG 연주/NNG 하/XSV 어/EC 드리/VX ㄴ답니다/EF
안나수이하면 떠오르는 이미지는 어떤것이 있으세요? 전 블랙과 바이올렛의 조화 그리고 꽃이 떠오른답니다. 많은 여자들의 가방속에 안나수이 거울 하나씩 필수품이었던 시절도 있었는데... 이번에는 헤어에센스로 안나수이 제품을 만나보았답니다.	안나수이/NNP 하/VV 면/EC 떠오르/VV 는/ETM 이미지/NNG 는/JX 어떤/MM 것/NNB 이/JKS 있/VA 으세요/EF ?/SF 저/NP ᆫ/JX 블랙/NNG 과/JC 바이올렛/NNG 의/JKG 조화/NNG 그리고/MAJ 꽃/NNG 이/JKS 떠오르/VV ㄴ답니다/EF ./SF 많/VA 은/ETM 여자/NNG 들/XSN 의/JKG 가방/NNG 속/NNG 에/JKB 안나수이/NNP 거울/NNG 하나/NR 씩/XSN 필수품/NNG 이/VCP 었/EP 던/ETM 시절/NNG 도/JX 있/VA 었/EP 는데/EF .../SF 이번/NNG 에/JKB 는/JX 헤어/NNG 에센스/NNG 로/JKB 안나수이/NNP 제품/NNG 을/JKO 만나/VV 어/EC 보/VX 었/EP 답니다/EF ./SF
분위기 반전의 기회를 잡은 두 팀 양 팀의 예상전술 맨유의 가장 큰 문제는 마샬 &  린가드의 아웃이다. 마샬 & 린가드는  산체스 & 마타보다 젋고 더 역동적인 선수들이다.	분위기/NNG 반전/NNG 의/JKG 기회/NNG 를/JKO 잡/VV 은/ETM 두/MM 팀/NNG 양/MM 팀/NNG 의/JKG 예상/NNG 전술/NNG 맨유/NNP 의/JKG 가장/MAG 크/VA ㄴ/ETM 문제/NNG 는/JX 마샬/NNP &/SW 린가드/NNP 의/JKG 아웃/NNG 이/VCP 다/EF ./SF 마샬/NNP &/SW 린가드/NNP 는/JX 산체스/NNP &/SW 마타/NNG 보다/JKB 젋/VV 고/EC 더/MAG 역동/NNG 적/XSN 이/VCP ㄴ/ETM 선수/NNG 들/XSN 이/VCP 다/EF ./SF
여러분, 내일은 따습게 옷입느세요!! 뉴스 내일 아침 전국 영하권 강추위	여러분/NP ,/SP 내일/NNG 은/JX 따습/VA 게/EC 옷/NNG 입/VV 느세요/EF !!/SF 뉴스/NNG 내일/NNG 아침/NNG 전국/NNG 영하/NNG 권/XSN 강추위/NNG
한강진 맛집 :: 쟈끄풀러 의외의 맛집 골목 제일기획 골목 초입에 자리잡은 이태리 레스토랑 오늘은 집에서 멀리 안 나가고 한글박물관에 들렸다가 가까운 한남동 맛집에서 점심을 해결하기로~.	한강진/NNP 맛집/NNG ::/SP 쟈끄풀러/NNP 의외/NNG 의/JKG 맛집/NNG 골목/NNG 제일기획/NNP 골목/NNG 초입/NNG 에/JKB 자리/NNG 잡/VV 은/ETM 이태리/NNP 레스토랑/NNG 오늘/NNG 은/JX 집/NNG 에서/JKB 멀리/MAG 안/MAG 나가/VV 고/EC 한글/NNG 박물관/NNG 에/JKB 들리/VV 었/EP 다가/EC 가깝/VA ㄴ/ETM 한남동/NNP 맛집/NNG 에서/JKB 점심/NNG 을/JKO 해결/NNG 하/XSV 기/ETN 로/JKB ~/SO ./SF
일본풍의 그릇하나 접시하나도 전부 제마음에 쏘옥 들었어요. 미소시루도 진짜 담백하니 하나도 짜지 않고 스시먹는 중간중간 목메임도 해결해주고 완전 제입맛에 딱이었는데 이 미소시루도 그릇이 빌때마다 계속 가득가득 채워주셔서 너무 감사했어요.	일본/NNP 풍/XSN 의/JKG 그릇/NNG 하나/NR 접시/NNG 하나/NR 도/JX 전부/MAG 저/NP 의/JKG 마음/NNG 에/JKB 쏘옥/MAG 들/VV 었/EP 어요/EF ./SF 미소시루/NNP 도/JX 진짜/MAG 담백하/VA 니/EC 하나/NR 도/JX 짜/VV 지/EC 않/VX 고/EC 스시/NNG 먹/VV 는/ETM 중간/NNG 중간/NNG 목메이/VV ᆷ/ETN 도/JX 해결/NNG 하/XSV 어/EC 주/VX 고/EC 완전/MAG 저/NP 의/JKG 입맛/NNG 에/JKB 딱/MAG 이/VCP 었/EP 는데/EC 이/MM 미소시루/NNP 도/JX 그릇/NNG 이/JKS 비/VV ᆯ/ETM 때/NNG 마다/JX 계속/MAG 가득가득/MAG 채우/VV 어/EC 주/VX 시/EP 어서/EC 너무/MAG 감사/NNG 하/XSV 었/EP 어요/EF ./SF
그리고는 또 마시고 싶은 음료없냐몈ㅋㅋㅋㅋㅋㅋㅋ 자몽허니블랙티를 사주었는데, 레시피가 진짜 최고 였습니다 이거 꼭 만들어먹으세요 저는 이제 자허블을 먹을 때면 꼭 이렇게 먹으려구요, 사이즈는 톨이었으며 클래식 시럼 -1 그리고 자몽소스 +1 하면 개꿀맛입니다 ㅋㅋㅋㅋㅋ	그리고/MAJ 는/JX 또/MAG 마시/VV 고/EC 싶/VX 은/ETM 음료/NNG 없/VA 냐며/EC ㅋㅋㅋㅋㅋㅋㅋㅋ/SW 자몽허니블랙티/NNP 를/JKO 사/VV 어/EC 주/VX 었/EP 는데/EC ,/SP 레시피/NNG 가/JKS 진짜/MAG 최고/NNG 이/VCP 었/EP 습니다/EF 이거/NP 꼭/MAG 만들/VV 어/EC 먹/VV 으세요/EF 저/NP 는/JX 이제/MAG 자허블/NNP 을/JKO 먹/VV 을/ETM 때/NNG 이/VCP 면/EC 꼭/MAG 이렇/VA 게/EC 먹/VV 으려구요/EF ,/SP 사이즈/NNG 는/JX 톨/NNG 이/VCP 었/EP 으며/EC 클래식/NNG 시럼/NNG -/SS 1/SN 그리고/MAJ 자몽/NNG 소스/NNG +/SW 1/SN 하/VV 면/EC 개/XPN 꿀맛/NNG 이/VCP ㅂ니다/EF ㅋㅋㅋㅋㅋ/SW
도쿄여행, 아시아나 항공 왕복 이용 기내식 후기 * 인천공항 비행기 타러 가는 길~ 아시아나항공 타고 도쿄여행 다녀온 이야기입니다 :) 여유있게 나선다고 나섰는데 주차하고 밥먹고 보안검색하고 인터넷 면세품 찾고 하는데 시간이 훅 지나가버려 막판에는 엄청 후달렸던 ㅎㅎㅎ	도쿄/NNP 여행/NNG ,/SP 아시아나/NNP 항공/NNG 왕복/NNG 이용/NNG 기내식/NNG 후기/NNG */SW 인천공항/NNP 비행기/NNG 타/VV 러/EC 가/VV 는/ETM 길/NNG ~/SO 아시아나항공/NNP 타/VV 고/EC 도쿄/NNP 여행/NNG 다녀오/VV ㄴ/ETM 이야기/NNG 이/VCP ㅂ니다/EF :/SP )/SSC 여유/NNG 있/VA 게/EC 나서/VV ㄴ다고/EC 나서/VV 었/EP 는데/EC 주차/NNG 하/XSV 고/EC 밥/NNG 먹/VV 고/EC 보안/NNG 검색/NNG 하/XSV 고/EC 인터넷/NNG 면세품/NNG 찾/VV 고/EC 하/VV 는/ETM 데/NNB 시간/NNG 이/JKS 훅/MAG 지나가/VV 어/EC 버리/VX 어/EC 막판/NNG 에/JKB 는/JX 엄청/MAG 후달리/VV 었/EP 던/ETM ㅎㅎㅎ/SW
KFC 마이징거버거 완전 내 스타일이얌~ 지난 금요일 작은 아이 학교 후 외출을 했었답니다. 수원역에 볼일이 있어 나갔다가 들린 곳은 KFC~ 제가 요기 치킨이랑 트위스터를 좋아라하거든요. 비스킷도요.^^ 볼일을 마치고 아이와 함께 맛난 간식을 먹으러 고고씽 합니다.	KFC/NNP 마이징거버거/NNP 완전/MAG 나/NP 의/JKG 스타일/NNG 이/VCP 얌/EF ~/SO 지난/MM 금요일/NNG 작/VA 은/ETM 아이/NNG 학교/NNG 후/NNG 외출/NNG 을/JKO 하/VV 었었/EP 답니다/EF ./SF 수원역/NNP 에/JKB 볼일/NNG 이/JKS 있/VA 어/EC 나가/VX 었/EP 다가/EC 들리/VV ㄴ/ETM 곳/NNG 은/JX KFC/NNP ~/SO 저/NP 가/JKS 요기/NP 치킨/NNG 이랑/JC 트위스터/NNP 를/JKO 좋/VA 어라/EC 하/VX 거든요/EF ./SF 비스킷/NNG 도/JX 요/JX ./SF ^^/SW 볼일/NNG 을/JKO 마치/VV 고/EC 아이/NNG 와/JKB 함께/MAG 맛나/VA ㄴ/ETM 간식/NNG 을/JKO 먹/VV 으러/EC 고고씽/NNG 하/XSV ㅂ니다/EF ./SF
얼마 만에 읽는 책인지 모르겠다. 어차피 덥고 목도 아파서 누워서 볼 만한 거 없을까 찾다가 받은지 1년만에 꺼내든 소설. 아무래도 영화로 처음 나왔을 때는 무척 보고 싶었지만 내용도 무겁고 어찌하다보니 때를 놓쳐서 점점 읽고 싶은 마음도 식었다.	얼마/NNG 만/NNB 에/JKB 읽/VV 는/ETM 책/NNG 이/VCP ㄴ지/EC 모르/VV 겠/EP 다/EF ./SF 어차피/MAG 덥/VA 고/EC 목/NNG 도/JX 아프/VA 어서/EC 눕/VV 어서/EC 보/VV ㄹ/ETM 만/NNB 하/XSA ㄴ/ETM 것/NNB 없/VA 을까/EC 찾/VV 다가/EC 받/VV 은/ETM 지/NNB 1/SN 년/NNB 만/NNB 에/JKB 꺼내/VV 어/EC 들/VV ᆫ/ETM 소설/NNG ./SF 아무래도/MAG 영화/NNG 로/JKB 처음/NNG 나오/VV 었/EP 을/ETM 때/NNG 는/JX 무척/MAG 보/VV 고/EC 싶/VX 었/EP 지만/EC 내용/NNG 도/JX 무겁/VA 고/EC 어찌/MAG 하/XSV 다/EC 보/VX 니/EC 때/NNG 를/JKO 놓치/VV 어서/EC 점점/MAG 읽/VV 고/EC 싶/VX 은/ETM 마음/NNG 도/JX 식/VV 었/EP 다/EF ./SF
그녀는 뜻밖에 고개를 흔들었습니다. “아니요, 저는 배에 남겠어요.” 이 말을 들은 여성의 남편이 “그러지말고 어서 타세요! 여보!”라고 말하자, 여성은 차분한 어조로 대답했습니다 “혼자 가지 않겠어요. 당신과 함께 이 배에 남을거에요.”	그녀/NP 는/JX 뜻밖에/MAG 고개/NNG 를/JKO 흔들/VV 었/EP 습니다/EF ./SF “/SSO 아니요/IC ,/SP 저/NP 는/JX 배/NNG 에/JKB 남/VV 겠/EP 어요/EF ./SF ”/SSC 이/MM 말/NNG 을/JKO 듣/VV 은/ETM 여성/NNG 의/JKG 남편/NNG 이/JKS “/SSO 그러/VV 지/EC 말/VX 고/EC 어서/MAG 타/VV 세요/EF !/SF 여보/IC !/SF ”/SSC 라고/JKQ 말/NNG 하/XSV 자/EC ,/SP 여성/NNG 은/JX 차분/XR 하/XSA ㄴ/ETM 어조/NNG 로/JKB 대답/NNG 하/XSV 었/EP 습니다/EF “/SSO 혼자/NNG 가/VV 지/EC 않/VX 겠/EP 어요/EF ./SF 당신/NP 과/JKB 함께/MAG 이/MM 배/NNG 에/JKB 남/VV 을/ETM 것/NNB 이/VCP 에요/EF ./SF ”/SSC
이장락의 멸시를 견디며 남안왕과 가까워지기 위해서 내가 얼마나 노력하고 갖은 애를 쓴 줄 아냐는 상여 이제야 전하가 나를 봐주나 했는데 너가 뭔데 전하를 빼앗아가냐며 너가 다 망쳐버렸고 다 너때문이라고한다	이장락/NNP 의/JKG 멸시/NNG 를/JKO 견디/VV 며/EC 남안왕/NNP 과/JKB 가까워지/VV 기/ETN 위하/VV 어서/EC 나/NP 가/JKS 얼마나/MAG 노력/NNG 하/XSV 고/EC 갖은/MM 애/NNG 를/JKO 쓰/VV ㄴ/ETM 줄/NNB 알/VV 냐는/ETM 상여/NNP 이제야/MAG 전하/NNG 가/JKS 나/NP 를/JKO 보/VV 어/EC 주/VX 나/EC 하/VV 었/EP 는데/EC 너/NP 가/JKS 뭐/NP 이/VCP ㄴ데/EC 전하/NNG 를/JKO 빼앗/VV 어/EC 가/VX 냐며/EC 너/NP 가/JKS 다/MAG 망치/VV 어/EC 버리/VX 었/EP 고/EC 다/MAG 너/NP 때문/NNB 이/VCP 라고/EC 하/VV ㄴ다/EF
사실 요즘 피부 케어에 대한 정보는 넘쳐난다. SNS에 접속해도, 모바일로 네이버에 접속해도, 티비를 틀어도, 잡지를 펼쳐도 피부 이야기가 많다. 또 요즘엔 피부과나 피부관리실에 정기적으로 가는 사람도 많고, 한 달 화장품 구입에 어마어마한 돈을 쓰는 사람도 많다. 화장품 종류는 어찌나 많은지.	사실/MAG 요즘/NNG 피부/NNG 케어/NNG 에/JKB 대하/VV ㄴ/ETM 정보/NNG 는/JX 넘치/VV 어/EC 나/VX ㄴ다/EF ./SF SNS/SL 에/JKB 접속/NNG 하/XSV 어도/EC ,/SP 모바일/NNG 로/JKB 네이버/NNP 에/JKB 접속/NNG 하/XSV 어도/EC ,/SP 티비/NNG 를/JKO 틀/VV 어도/EC ,/SP 잡지/NNG 를/JKO 펼치/VV 어도/EC 피부/NNG 이야기/NNG 가/JKS 많/VA 다/EF ./SF 또/MAG 요즘/NNG 에/JKB ㄴ/JX 피부과/NNG 나/JC 피부/NNG 관리실/NNG 에/JKB 정기/NNG 적/XSN 으로/JKB 가/VV 는/ETM 사람/NNG 도/JX 많/VA 고/EC ,/SP 한/MM 달/NNB 화장품/NNG 구입/NNG 에/JKB 어마어마/XR 하/XSA ㄴ/ETM 돈/NNG 을/JKO 쓰/VV 는/ETM 사람/NNG 도/JX 많/VA 다/EF ./SF 화장품/NNG 종류/NNG 는/JX 어찌나/MAG 많/VA 은지/EF ./SF
한방약까지 함께 병행하며 열심히 관리하고 있어여ㅠ_ㅠ 일단 지금까지 경과를 보면 ㅎㅁㅎ 두피가 이전보다 많이 건강해져서 기름과 각질이 엄청나게 많던 제 두피가 많이 호전되었다는건데용 이미 빠진 머리는 어떻게 된지 모르겠으나 잔디같이 ㅋㅋㅋㅋㅋㅋㅋㅋㅋ 앞에 살짝 잔머리들이 올라오고 있어가지고 ㅎㅎㅎ	한방/NNG 약/NNG 까지/JX 함께/MAG 병행/NNG 하/XSV 며/EC 열심히/MAG 관리/NNG 하/XSV 고/EC 있/VX 어여/EF ㅠ_ㅠ/SW 일단/MAG 지금/NNG 까지/JX 경과/NNG 를/JKO 보/VV 면/EC ㅎㅁㅎ/SW 두피/NNG 가/JKS 이전/NNG 보다/JKB 많이/MAG 건강/NNG 하/XSA 어/EC 지/VX 어서/EC 기름/NNG 과/JC 각질/NNG 이/JKS 엄청나/VA 게/EC 많/VA 던/ETM 저/NP 의/JKG 두피/NNG 가/JKS 많이/MAG 호전/NNG 되/XSV 었/EP 다는/ETM 것/NNB 이/VCP ㄴ데용/EC 이미/MAG 빠지/VV ㄴ/ETM 머리/NNG 는/JX 어떻/VA 게/EC 되/VV ᆫ/ETM 지/NNB 모르/VV 겠/EP 으나/EC 잔디/NNG 같이/JKB ㅋㅋㅋㅋㅋㅋㅋㅋㅋ/SW 앞/NNG 에/JKB 살짝/MAG 잔머리/NNG 들/XSN 이/JKS 올라오/VV 고/EC 있/VX 어/EC 가지/VX 고/EC ㅎㅎㅎ/SW
지금 폴리젠샴푸 폴리젠트리트먼트 폴리젠토닉까지 다양하게 사용 중이에요 두피는 피부의 호흡 중 약 80%를 차지하며 얼굴의 처짐과 탄력과도 아주 밀접한 관계가 있는 피부 부위에요	지금/MAG 폴리젠샴푸/NNP 폴리젠트리트먼트/NNP 폴리젠토닉/NNP 까지/JX 다양/NNG 하/XSA 게/EC 사용/NNG 중/NNB 이/VCP 에요/EF 두피/NNG 는/JX 피부/NNG 의/JKG 호흡/NNG 중/NNB 약/MM 80/SN %/SW 를/JKO 차지/NNG 하/XSV 며/EC 얼굴/NNG 의/JKG 처지/VV ᆷ/ETN 과/JC 탄력/NNG 과/JKB 도/JX 아주/MAG 밀접/NNG 하/XSA ㄴ/ETM 관계/NNG 가/JKS 있/VA 는/ETM 피부/NNG 부위/NNG 에/JKB 요/JX
전북 전주여행 첫번째로 방문한 맛집! 베테랑 칼국수! 방문전 맛집 어디어디가 좋다더라 검색하고 간집인데... 전주 여행하시는 분들 거의 대부분 여기 추천 하길래 방문 ㅎ (근데 좀 호불호가 갈리는집)	전북/NNP 전주/NNP 여행/NNG 첫/MM 번/NNB 째/XSN 로/JKB 방문/NNG 하/XSV ㄴ/ETM 맛/NNG 집/NNG !/SF 베테랑/NNG 칼국수/NNG !/SF 방문/NNG 전/NNG 맛집/NNG 어디/NP 어디/NP 가/JKS 좋/VA 다더라/EC 검색/NNG 하/XSV 고/EC 가/VV ᆫ/ETM 집/NNG 이/VCP ㄴ데/EC .../SF 전주/NNP 여행/NNG 하/XSV 시/EP 는/ETM 분/NNB 들/XSN 거의/MAG 대부분/NNG 여기/NP 추천/NNG 하/XSV 길래/EC 방문/NNG ㅎ/SW (/SSO 근데/MAJ 좀/MAG 호불호/NNG 가/JKS 갈리/VV 는/ETM 집/NNG )/SSC
아 탱글탱글한 대게살... 요것도 참 맛있답니다 대게튀김이예요.. 전에는 작은바구니에 나왔는데.. 큰바구니로 바뀌었네요.. 그래서 조금 적어보이는거같기도하궁..ㅋㅋㅋ	아/IC 탱글탱글/MAG 하/XSA ㄴ/ETM 대게살/NNG .../SF 요것/NP 도/JX 참/MAG 맛있/VA 답니다/EF 대게/NNG 튀김/NNG 이/VCP 예요/EF ../SF 전/NNG 에/JKB 는/JX 작/VA 은/ETM 바구니/NNG 에/JKB 나오/VV 었/EP 는데/EF ../SF 크/VA ᆫ/ETM 바구니/NNG 로/JKB 바뀌/VV 었/EP 네/EF 요/JX ../SF 그래서/MAJ 조금/MAG 적/VA 어/EC 보이/VV 는/ETM 것/NNB 같/VA 기/ETN 도/JX 하/VX 궁/EF ../SF ㅋㅋㅋ/SW
비누는 사용할때 비누통에 넣어서 사용하세요~~ 수분이 많으면 녹아내려요~~ 비누 사용시엔 페이스타올을 사용하면 거품도 잘나고 피부 세턱에 큰 도움이 됩니다.^^	비누/NNG 는/JX 사용/NNG 하/XSV ㄹ/ETM 때/NNG 비누/NNG 통/NNG 에/JKB 넣/VV 어서/EC 사용/NNG 하/XSV 세요/EF ~~/SO 수분/NNG 이/JKS 많/VA 으면/EC 녹아내리/VV 어요/EC ~~/SO 비누/NNG 사용/NNG 시/NNB 에/JKB ㄴ/JX 페이스/NNG 타올/NNG 을/JKO 사용/NNG 하/XSV 면/EC 거품/NNG 도/JX 잘/MAG 나/VV 고/EC 피부/NNG 세턱/NNG 에/JKB 크/VA ㄴ/ETM 도움/NNG 이/JKC 되/VV ㅂ니다/EF ./SF ^^/SW
우측은 한 두번 헤어플러스샴푸 사용했다고 훨씬 보들보들 차분해진머리카락이에요 머리를 다 자르려고 했던 저로써는 정말 너무너무 만족스럽고 일단 빗질이 된다는거에 너무감사	우측/NNG 은/JX 한/MM 두/MM 번/NNB 헤어플러스샴푸/NNP 사용/NNG 하/XSV 었/EP 다고/EC 훨씬/MAG 보들보들/MAG 차분/XR 하/XSA 어/EC 지/VX ᆫ/ETM 머리카락/NNG 이/VCP 에요/EF 머리/NNG 를/JKO 다/MAG 자르/VV 려고/EC 하/VV 었/EP 던/ETM 저/NP 로써/JKB 는/JX 정말/MAG 너무너무/MAG 만족/NNG 스럽/XSA 고/EC 일단/MAG 빗/NNG 질/XSN 이/JKC 되/VV ㄴ다는/ETM 것/NNB 에/JKB 너무/MAG 감사/NNG
그러니 `제이슨 스타뎀`만 바라보고 영화를 감상한다면 큰 낭패를 맛볼 수 있다. <트랜스포터>나 <아드레날린>과 같은 빠르고 호쾌한 액션따윈 없으니 말이다.	그러/VV 니/EC `/SW 제이슨/NNP 스타뎀/NNP `/SW 만/JX 바라보/VV 고/EC 영화/NNG 를/JKO 감상/NNG 하/XSV ㄴ다면/EC 크/VA ㄴ/ETM 낭패/NNG 를/JKO 맛보/VV ㄹ/ETM 수/NNB 있/VA 다/EF ./SF </SSO 트랜스포터/NNP >/SSC 나/JC </SSO 아드레날린/NNP >/SSC 과/JKB 같/VA 은/ETM 빠르/VA 고/EC 호쾌하/VA ㄴ/ETM 액션/NNG 따위/NNB ㄴ/JX 없/VA 으니/EC 말/NNG 이/VCP 다/EF ./SF
LA갈비랑 전복은 맛있으니까 계속 먹어주고~ㅎㅎ 그릴코너에서 양갈비도 갖고 왔어요. 양갈비 냄새가 과하지 않고, 육질도 괜찮아서 맛있게 먹었어요,^-^	LA/SL 갈비/NNG 랑/JC 전복/NNG 은/JX 맛있/VA 으니까/EC 계속/MAG 먹/VV 어/EC 주/VX 고/EC ~/SO ㅎㅎ/SW 그릴/NNG 코너/NNG 에서/JKB 양갈비/NNG 도/JX 갖/VV 고/EC 오/VV 었/EP 어요/EF ./SF 양/NNG 갈비/NNG 냄새/NNG 가/JKS 과하/VA 지/EC 않/VX 고/EC ,/SP 육질/NNG 도/JX 괜찮/VA 어서/EC 맛있/VA 게/EC 먹/VV 었/EP 어요/EC ,/SP ^/SW -/SO ^/SW
쉐프의 정육점 정육점에서는 워터에이징된 숙성육(한우, 간편한 스테이크팩, 금돼지, 삼겹살)과 쉐프 부모님께서 직접 재배한 채소들과 기름들도 함께 판매하고 있어요.  워터에이징?물속에서1~2도의 온도를 일정하게 유기시키는 엄격하고 섬세한 과정을 거친 숙성육으로 육질이 연하며 진한 풍미가 살아있어 깊고 부드러운 맛을 볼수 있음.	쉐프/NNG 의/JKG 정육점/NNG 정육점/NNG 에서/JKB 는/JX 워터/NNG 에이징/NNG 되/XSV ㄴ/ETM 숙성육/NNG (/SSO 한우/NNG ,/SP 간편/XR 하/XSA ㄴ/ETM 스테이크/NNG 팩/NNG ,/SP 금/NNG 돼지/NNG ,/SP 삼겹살/NNG )/SSC 과/JC 쉐프/NNG 부모/NNG 님/XSN 께서/JKS 직접/MAG 재배/NNG 하/XSV ㄴ/ETM 채소/NNG 들/XSN 과/JKB 기름/NNG 들/XSN 도/JX 함께/MAG 판매/NNG 하/XSV 고/EC 있/VX 어요/EF ./SF 워터/NNG 에이징/NNG ?/SF 물/NNG 속/NNG 에서/JKB 1/SN ~/SO 2/SN 도/NNB 의/JKG 온도/NNG 를/JKO 일정/NNG 하/XSA 게/EC 유기/NNG 시키/XSV 는/ETM 엄격/XR 하/XSA 고/EC 섬세/XR 하/XSA ㄴ/ETM 과정/NNG 을/JKO 거치/VV ㄴ/ETM 숙성육/NNG 으로/JKB 육질/NNG 이/JKS 연하/VA 며/EC 진하/VA ㄴ/ETM 풍미/NNG 가/JKS 살/VV 어/EC 있/VX 어/EC 깊/VA 고/EC 부드럽/VA ㄴ/ETM 맛/NNG 을/JKO 보/VV ㄹ/ETM 수/NNB 있/VA 음/EF ./SF
“아주 재미있고, 놀라움이 가득하다”(Nerdist), “즐거움의 연속! 논스톱 액션 어드벤처로 보는 내내 웃음이 떠나지 않는다”(Gizmodo)	“/SSO 아주/MAG 재미있/VA 고/EC ,/SP 놀랍/VA 음/ETN 이/JKS 가득/MAG 하/XSA 다/EF ”/SSC (/SSO Nerdist/SL )/SSC ,/SP “/SSO 즐거움/NNG 의/JKG 연속/NNG !/SF 논스톱/NNG 액션/NNG 어드벤처/NNG 로/JKB 보/VV 는/ETM 내내/MAG 웃음/NNG 이/JKS 떠나/VV 지/EC 않/VX 는다/EF ”/SSC (/SSO Gizmodo/SL )/SSC
역시 분위기가 좋으니 많이들 찾아오시는듯해요 헤헤 전체적으로 분위기가 진짜 좋아요 :) 약간 엔틱한 느낌도있고, 부드럽진 않지만 조명 덕분에 아늑한 분위기도 연출되고~	역시/MAG 분위기/NNG 가/JKS 좋/VA 으니/EC 많이/MAG 들/XSN 찾아오/VV 시/EP 는/ETM 듯/NNB 하/XSA 어요/EF 헤헤/MAG 전체/NNG 적/XSN 으로/JKB 분위기/NNG 가/JKS 진짜/MAG 좋/VA 어요/EF :/SP )/SSC 약간/MAG 엔틱/NNG 하/XSA ㄴ/ETM 느낌/NNG 도/JX 있/VA 고/EC ,/SP 부드럽/VA 지/EC ㄴ/JX 않/VX 지만/EC 조명/NNG 덕분/NNG 에/JKB 아늑/XR 하/XSA ㄴ/ETM 분위기/NNG 도/JX 연출/NNG 되/XSV 고/EC ~/SO
그리고 후반부로 갈수록 감정의 드라마가 조금 더 진해지면서 비로소 긴장감과 속도감을 찾아 몰입도를 높이기도 한다. 배우들의 명연기가 여기에서 위력을 발휘한다.	그리고/MAJ 후반부/NNG 로/JKB 가/VV ᆯ수록/EC 감정/NNG 의/JKG 드라마/NNG 가/JKS 조금/MAG 더/MAG 진하/VA 어/EC 지/VX 면서/EC 비로소/MAG 긴장감/NNG 과/JC 속도감/NNG 을/JKO 찾/VV 어/EC 몰입도/NNG 를/JKO 높이/VV 기/ETN 도/JX 하/VX ㄴ다/EF ./SF 배우/NNG 들/XSN 의/JKG 명/XPN 연기/NNG 가/JKS 여기/NP 에서/JKB 위력/NNG 을/JKO 발휘/NNG 하/XSV ㄴ다/EF ./SF
수원 미용실 헤어다이아수원역점 지연디자이너쌤 손으로 탄생한 깔끔하고 자연스러운 남자 가르마펌. 오빠도 만족하고 저도 만족했어요 ! 남자펌은 여자들이랑 다르게 컷하고 펌하는데까지 1시간30분 정도 밖에 안걸려서 지루하다 생각이 들지 않았어요.	수원/NNP 미용실/NNG 헤어다이아/NNP 수원역/NNP 점/NNG 지연/NNP 디자이너/NNG 쌤/NNG 손/NNG 으로/JKB 탄생/NNG 하/XSV ㄴ/ETM 깔끔/XR 하/XSA 고/EC 자연/NNG 스럽/XSA ㄴ/ETM 남자/NNG 가르마펌/NNG ./SF 오빠/NNG 도/JX 만족/NNG 하/XSA 고/EC 저/NP 도/JX 만족/NNG 하/XSA 었/EP 어요/EF !/SF 남자/NNG 펌/NNG 은/JX 여자/NNG 들/XSN 이랑/JKB 다르/VA 게/EC 컷/NNG 하/XSV 고/EC 펌/NNG 하/XSV 는/ETM 데/NNB 까지/JX 1/SN 시간/NNB 30/SN 분/NNB 정도/NNG 밖/NNG 에/JKB 안/MAG 걸리/VV 어서/EC 지루/XR 하/XSA 다/EC 생각/NNG 이/JKS 들/VV 지/EC 않/VX 었/EP 어요/EF ./SF
